"Tanggal Transaksi","Keterangan","Cabang","Jumlah","Saldo"
"01/02","KR OTOMATIS 31/01/2021 16:05 FLAZZ 885000750597 TRANSJOGJA-HO 20210129EPB0741907 0013000 ","0998","10,800.00 CR","508,971,205.65"
"01/02","KR OTOMATIS 31/01/2021 16:05 FLAZZ 885000750597 TRANSJOGJA-HO 20210129EPB0744201 8013000 ","0998","2,700.00 CR","508,973,905.65"
"01/02","KR OTOMATIS 31/01/2021 16:05 FLAZZ 885000750597 TRANSJOGJA-HO 20210129EPB0744702 9013000 ","0998","2,700.00 CR","508,976,605.65"
"01/02","KR OTOMATIS 31/01/2021 16:05 FLAZZ 885000750597 TRANSJOGJA-HO 20210129EPB1313400 3013000 ","0998","2,700.00 CR","508,979,305.65"
"01/02","KR OTOMATIS 31/01/2021 16:05 FLAZZ 885000750597 TRANSJOGJA-HO 20210129EPB1314000 6013000 ","0998","2,700.00 CR","508,982,005.65"
"01/02","KR OTOMATIS 31/01/2021 16:05 FLAZZ 885000750597 TRANSJOGJA-HO 20210129EPB3501700 9013000 ","0998","2,700.00 CR","508,984,705.65"
"01/02","KR OTOMATIS 31/01/2021 16:05 FLAZZ 885000750597 TRANSJOGJA-HO 20210129EPB4764500 8013000 ","0998","2,700.00 CR","508,987,405.65"
"01/02","KR OTOMATIS 31/01/2021 16:05 FLAZZ 885000750597 TRANSJOGJA-HO 20210129EPB5337001 3013000 ","0998","2,700.00 CR","508,990,105.65"
"01/02","KR OTOMATIS 31/01/2021 16:05 FLAZZ 885000750597 TRANSJOGJA-HO 20210129EPB5337604 3013000 ","0998","2,700.00 CR","508,992,805.65"
"01/02","KR OTOMATIS 31/01/2021 16:05 FLAZZ 885000750597 TRANSJOGJA-HO 20210129EPB5338504 0013000 ","0998","2,700.00 CR","508,995,505.65"
"01/02","KR OTOMATIS 31/01/2021 16:05 FLAZZ 885000750597 TRANSJOGJA-HO 20210129EPB5339402 0013000 ","0998","2,700.00 CR","508,998,205.65"
"01/02","KR OTOMATIS 31/01/2021 16:05 FLAZZ 885000750597 TRANSJOGJA-HO 20210129EPB5339501 8013000 ","0998","2,700.00 CR","509,000,905.65"
"01/02","KR OTOMATIS 31/01/2021 16:05 FLAZZ 885000750597 TRANSJOGJA-HO 20210129EPB5339901 9013000 ","0998","2,700.00 CR","509,003,605.65"
"01/02","KR OTOMATIS 31/01/2021 16:05 FLAZZ 885000750597 TRANSJOGJA-HO 20210130EPB0742401 9013000 ","0998","2,700.00 CR","509,006,305.65"
"01/02","KR OTOMATIS 31/01/2021 16:05 FLAZZ 885000750597 TRANSJOGJA-HO 20210130EPB0742801 0013000 ","0998","2,700.00 CR","509,009,005.65"
"01/02","KR OTOMATIS 31/01/2021 16:05 FLAZZ 885000750597 TRANSJOGJA-HO 20210130EPB0744300 8013000 ","0998","2,700.00 CR","509,011,705.65"
"01/02","KR OTOMATIS 31/01/2021 16:05 FLAZZ 885000750597 TRANSJOGJA-HO 20210130EPB0744901 2013000 ","0998","5,400.00 CR","509,017,105.65"
"01/02","KR OTOMATIS 31/01/2021 16:05 FLAZZ 885000750597 TRANSJOGJA-HO 20210130EPB1314401 5013000 ","0998","2,700.00 CR","509,019,805.65"
"01/02","KR OTOMATIS 31/01/2021 16:05 FLAZZ 885000750597 TRANSJOGJA-HO 20210130EPB5336000 5013000 ","0998","5,400.00 CR","509,025,205.65"
"01/02","KR OTOMATIS 31/01/2021 16:05 FLAZZ 885000750597 TRANSJOGJA-HO 20210130EPB5336601 6013000 ","0998","5,400.00 CR","509,030,605.65"
"01/02","KR OTOMATIS 31/01/2021 16:05 FLAZZ 885000750597 TRANSJOGJA-HO 20210130EPB5337200 1013000 ","0998","13,500.00 CR","509,044,105.65"
"01/02","KR OTOMATIS 31/01/2021 16:05 FLAZZ 885000750597 TRANSJOGJA-HO 20210130EPB5337604 4013000 ","0998","13,500.00 CR","509,057,605.65"
"01/02","KR OTOMATIS 31/01/2021 16:05 FLAZZ 885000750597 TRANSJOGJA-HO 20210130EPB5337801 9013000 ","0998","5,400.00 CR","509,063,005.65"
"01/02","KR OTOMATIS 31/01/2021 16:05 FLAZZ 885000750597 TRANSJOGJA-HO 20210130EPB5338504 1013000 ","0998","2,700.00 CR","509,065,705.65"
"01/02","KR OTOMATIS 31/01/2021 16:05 FLAZZ 885000750597 TRANSJOGJA-HO 20210130EPB5339501 9013000 ","0998","5,400.00 CR","509,071,105.65"
"01/02","KR OTOMATIS 31/01/2021 16:05 FLAZZ 885000750597 TRANSJOGJA-HO 20210130EPB0742201 4013000 ","0998","2,700.00 CR","509,073,805.65"
"01/02","KR OTOMATIS 31/01/2021 16:05 FLAZZ 885000750597 TRANSJOGJA-HO 20210130EPB0743101 1013000 ","0998","2,700.00 CR","509,076,505.65"
"01/02","KR OTOMATIS 31/01/2021 16:05 FLAZZ 885000750597 TRANSJOGJA-HO 20210130EPB0744703 0013000 ","0998","2,700.00 CR","509,079,205.65"
"01/02","KR OTOMATIS 31/01/2021 16:05 FLAZZ 885000750597 TRANSJOGJA-HO 20210130EPB1311701 5013000 ","0998","2,700.00 CR","509,081,905.65"
"01/02","KR OTOMATIS 31/01/2021 16:05 FLAZZ 885000750597 TRANSJOGJA-HO 20210130EPB1314201 6013000 ","0998","5,400.00 CR","509,087,305.65"
"01/02","KR OTOMATIS 31/01/2021 16:05 FLAZZ 885000750597 TRANSJOGJA-HO 20210130EPB4764500 9013000 ","0998","2,700.00 CR","509,090,005.65"
"01/02","KR OTOMATIS 31/01/2021 16:05 FLAZZ 885000750597 TRANSJOGJA-HO 20210130EPB5336802 4013000 ","0998","2,700.00 CR","509,092,705.65"
"01/02","KR OTOMATIS 31/01/2021 16:05 FLAZZ 885000750597 TRANSJOGJA-HO 20210130EPB5337001 4013000 ","0998","2,700.00 CR","509,095,405.65"
"01/02","KR OTOMATIS 31/01/2021 16:05 FLAZZ 885000750597 TRANSJOGJA-HO 20210130EPB5337301 9013000 ","0998","2,700.00 CR","509,098,105.65"
"01/02","KR OTOMATIS 31/01/2021 16:05 FLAZZ 885000750597 TRANSJOGJA-HO 20210130EPB5338006 6013000 ","0998","2,700.00 CR","509,100,805.65"
"01/02","KR OTOMATIS 31/01/2021 16:05 FLAZZ 885000750597 TRANSJOGJA-HO 20210130EPB5339402 1013000 ","0998","2,700.00 CR","509,103,505.65"
"01/02","KR OTOMATIS 31/01/2021 16:05 FLAZZ 885000750597 TRANSJOGJA-HO 20210129EPB0742201 3013000 ","0998","2,700.00 CR","509,106,205.65"
"01/02","KR OTOMATIS 31/01/2021 16:05 FLAZZ 885000750597 TRANSJOGJA-HO 20210129EPB0743306 2013000 ","0998","13,500.00 CR","509,119,705.65"
"01/02","KR OTOMATIS 31/01/2021 16:05 FLAZZ 885000750597 TRANSJOGJA-HO 20210129EPB0745001 4013000 ","0998","2,700.00 CR","509,122,405.65"
"01/02","KR OTOMATIS 31/01/2021 16:05 FLAZZ 885000750597 TRANSJOGJA-HO 20210129EPB1313702 0013000 ","0998","2,700.00 CR","509,125,105.65"
"01/02","KR OTOMATIS 31/01/2021 16:05 FLAZZ 885000750597 TRANSJOGJA-HO 20210129EPB1314802 4013000 ","0998","2,700.00 CR","509,127,805.65"
"01/02","KR OTOMATIS 31/01/2021 16:05 FLAZZ 885000750597 TRANSJOGJA-HO 20210129EPB4353106 6013000 ","0998","2,700.00 CR","509,130,505.65"
"01/02","KR OTOMATIS 31/01/2021 16:05 FLAZZ 885000750597 TRANSJOGJA-HO 20210129EPB5336802 3013000 ","0998","2,700.00 CR","509,133,205.65"
"01/02","KR OTOMATIS 31/01/2021 16:05 FLAZZ 885000750597 TRANSJOGJA-HO 20210129EPB5337801 8013000 ","0998","5,400.00 CR","509,138,605.65"
"01/02","KR OTOMATIS 31/01/2021 16:05 FLAZZ 885000750597 TRANSJOGJA-HO 20210129EPB5338206 8013000 ","0998","8,100.00 CR","509,146,705.65"
"01/02","KR OTOMATIS 31/01/2021 16:05 FLAZZ 885000750597 TRANSJOGJA-HO 20210129EPB5339102 2013000 ","0998","2,700.00 CR","509,149,405.65"
"01/02","KR OTOMATIS 31/01/2021 16:05 FLAZZ 885000750597 TRANSJOGJA-HO 20210129EPB5339701 1013000 ","0998","2,700.00 CR","509,152,105.65"
"01/02","KR OTOMATIS 31/01/2021 16:05 FLAZZ 885000750597 TRANSJOGJA-HO 20210129EPB5375100 9013000 ","0998","2,700.00 CR","509,154,805.65"
"01/02","KR OTOMATIS 01/02/2021 16:05 FLAZZ 885000750597 TRANSJOGJA-HO 20210131EPB0741802 6013000 ","0998","2,700.00 CR","509,157,505.65"
"01/02","KR OTOMATIS 01/02/2021 16:05 FLAZZ 885000750597 TRANSJOGJA-HO 20210131EPB0741907 1013000 ","0998","24,300.00 CR","509,181,805.65"
"01/02","KR OTOMATIS 01/02/2021 16:05 FLAZZ 885000750597 TRANSJOGJA-HO 20210131EPB0743901 0013000 ","0998","2,700.00 CR","509,184,505.65"
"01/02","KR OTOMATIS 01/02/2021 16:05 FLAZZ 885000750597 TRANSJOGJA-HO 20210131EPB0744703 1013000 ","0998","2,700.00 CR","509,187,205.65"
"01/02","KR OTOMATIS 01/02/2021 16:05 FLAZZ 885000750597 TRANSJOGJA-HO 20210131EPB1311600 3013000 ","0998","5,400.00 CR","509,192,605.65"
"01/02","KR OTOMATIS 01/02/2021 16:05 FLAZZ 885000750597 TRANSJOGJA-HO 20210131EPB1313702 1013000 ","0998","5,400.00 CR","509,198,005.65"
"01/02","KR OTOMATIS 01/02/2021 16:05 FLAZZ 885000750597 TRANSJOGJA-HO 20210131EPB4764501 0013000 ","0998","2,700.00 CR","509,200,705.65"
"01/02","KR OTOMATIS 01/02/2021 16:05 FLAZZ 885000750597 TRANSJOGJA-HO 20210131EPB5338206 9013000 ","0998","2,700.00 CR","509,203,405.65"
"01/02","KR OTOMATIS 01/02/2021 16:05 FLAZZ 885000750597 TRANSJOGJA-HO 20210131EPB5339402 2013000 ","0998","2,700.00 CR","509,206,105.65"
"01/02","KR OTOMATIS 01/02/2021 16:05 FLAZZ 885000750597 TRANSJOGJA-HO 20210131EPB0741301 0013000 ","0998","2,700.00 CR","509,208,805.65"
"01/02","KR OTOMATIS 01/02/2021 16:05 FLAZZ 885000750597 TRANSJOGJA-HO 20210131EPB0742201 5013000 ","0998","2,700.00 CR","509,211,505.65"
"01/02","KR OTOMATIS 01/02/2021 16:05 FLAZZ 885000750597 TRANSJOGJA-HO 20210131EPB0743001 0013000 ","0998","2,700.00 CR","509,214,205.65"
"01/02","KR OTOMATIS 01/02/2021 16:05 FLAZZ 885000750597 TRANSJOGJA-HO 20210131EPB0744101 3013000 ","0998","2,700.00 CR","509,216,905.65"
"01/02","KR OTOMATIS 01/02/2021 16:05 FLAZZ 885000750597 TRANSJOGJA-HO 20210131EPB1311701 6013000 ","0998","5,400.00 CR","509,222,305.65"
"01/02","KR OTOMATIS 01/02/2021 16:05 FLAZZ 885000750597 TRANSJOGJA-HO 20210131EPB4353106 7013000 ","0998","2,700.00 CR","509,225,005.65"
"01/02","KR OTOMATIS 01/02/2021 16:05 FLAZZ 885000750597 TRANSJOGJA-HO 20210131EPB5336601 7013000 ","0998","8,100.00 CR","509,233,105.65"
"01/02","KR OTOMATIS 01/02/2021 16:05 FLAZZ 885000750597 TRANSJOGJA-HO 20210131EPB5338504 2013000 ","0998","2,700.00 CR","509,235,805.65"
"01/02","KR OTOMATIS 01/02/2021 16:05 FLAZZ 885000750597 TRANSJOGJA-HO 20210131EPB5339502 0013000 ","0998","2,700.00 CR","509,238,505.65"
"02/02","KR OTOMATIS 02/02/2021 16:05 FLAZZ 885000750597 TRANSJOGJA-HO 20210201EPB0741501 2013000 ","0998","2,700.00 CR","509,241,205.65"
"02/02","KR OTOMATIS 02/02/2021 16:05 FLAZZ 885000750597 TRANSJOGJA-HO 20210201EPB0741907 2013000 ","0998","32,400.00 CR","509,273,605.65"
"02/02","KR OTOMATIS 02/02/2021 16:05 FLAZZ 885000750597 TRANSJOGJA-HO 20210201EPB0742402 0013000 ","0998","2,700.00 CR","509,276,305.65"
"02/02","KR OTOMATIS 02/02/2021 16:05 FLAZZ 885000750597 TRANSJOGJA-HO 20210201EPB0742706 1013000 ","0998","13,500.00 CR","509,289,805.65"
"02/02","KR OTOMATIS 02/02/2021 16:05 FLAZZ 885000750597 TRANSJOGJA-HO 20210201EPB0743200 4013000 ","0998","2,700.00 CR","509,292,505.65"
"02/02","KR OTOMATIS 02/02/2021 16:05 FLAZZ 885000750597 TRANSJOGJA-HO 20210201EPB0744300 9013000 ","0998","2,700.00 CR","509,295,205.65"
"02/02","KR OTOMATIS 02/02/2021 16:05 FLAZZ 885000750597 TRANSJOGJA-HO 20210201EPB0744703 2013000 ","0998","5,400.00 CR","509,300,605.65"
"02/02","KR OTOMATIS 02/02/2021 16:05 FLAZZ 885000750597 TRANSJOGJA-HO 20210201EPB1311701 7013000 ","0998","2,700.00 CR","509,303,305.65"
"02/02","KR OTOMATIS 02/02/2021 16:05 FLAZZ 885000750597 TRANSJOGJA-HO 20210201EPB1314000 7013000 ","0998","2,700.00 CR","509,306,005.65"
"02/02","KR OTOMATIS 02/02/2021 16:05 FLAZZ 885000750597 TRANSJOGJA-HO 20210201EPB1314802 5013000 ","0998","2,700.00 CR","509,308,705.65"
"02/02","KR OTOMATIS 02/02/2021 16:05 FLAZZ 885000750597 TRANSJOGJA-HO 20210201EPB5336101 1013000 ","0998","5,400.00 CR","509,314,105.65"
"02/02","KR OTOMATIS 02/02/2021 16:05 FLAZZ 885000750597 TRANSJOGJA-HO 20210201EPB5337001 5013000 ","0998","5,400.00 CR","509,319,505.65"
"02/02","KR OTOMATIS 02/02/2021 16:05 FLAZZ 885000750597 TRANSJOGJA-HO 20210201EPB5338207 0013000 ","0998","8,100.00 CR","509,327,605.65"
"02/02","KR OTOMATIS 02/02/2021 16:05 FLAZZ 885000750597 TRANSJOGJA-HO 20210201EPB5339000 2013000 ","0998","2,700.00 CR","509,330,305.65"
"02/02","KR OTOMATIS 02/02/2021 16:05 FLAZZ 885000750597 TRANSJOGJA-HO 20210201EPB5373302 0013000 ","0998","5,400.00 CR","509,335,705.65"
"02/02","KR OTOMATIS 02/02/2021 16:05 FLAZZ 885000750597 TRANSJOGJA-HO 20210201EPB0741802 7013000 ","0998","5,400.00 CR","509,341,105.65"
"02/02","KR OTOMATIS 02/02/2021 16:05 FLAZZ 885000750597 TRANSJOGJA-HO 20210201EPB0742001 0013000 ","0998","8,100.00 CR","509,349,205.65"
"02/02","KR OTOMATIS 02/02/2021 16:05 FLAZZ 885000750597 TRANSJOGJA-HO 20210201EPB0742201 6013000 ","0998","18,900.00 CR","509,368,105.65"
"02/02","KR OTOMATIS 02/02/2021 16:05 FLAZZ 885000750597 TRANSJOGJA-HO 20210201EPB0742801 1013000 ","0998","2,700.00 CR","509,370,805.65"
"02/02","KR OTOMATIS 02/02/2021 16:05 FLAZZ 885000750597 TRANSJOGJA-HO 20210201EPB0742900 9013000 ","0998","5,400.00 CR","509,376,205.65"
"02/02","KR OTOMATIS 02/02/2021 16:05 FLAZZ 885000750597 TRANSJOGJA-HO 20210201EPB0743306 3013000 ","0998","2,700.00 CR","509,378,905.65"
"02/02","KR OTOMATIS 02/02/2021 16:05 FLAZZ 885000750597 TRANSJOGJA-HO 20210201EPB0745001 5013000 ","0998","2,700.00 CR","509,381,605.65"
"02/02","KR OTOMATIS 02/02/2021 16:05 FLAZZ 885000750597 TRANSJOGJA-HO 20210201EPB1310901 6013000 ","0998","2,700.00 CR","509,384,305.65"
"02/02","KR OTOMATIS 02/02/2021 16:05 FLAZZ 885000750597 TRANSJOGJA-HO 20210201EPB1313600 8013000 ","0998","2,700.00 CR","509,387,005.65"
"02/02","KR OTOMATIS 02/02/2021 16:05 FLAZZ 885000750597 TRANSJOGJA-HO 20210201EPB1314401 6013000 ","0998","2,700.00 CR","509,389,705.65"
"02/02","KR OTOMATIS 02/02/2021 16:05 FLAZZ 885000750597 TRANSJOGJA-HO 20210201EPB5336601 8013000 ","0998","2,700.00 CR","509,392,405.65"
"02/02","KR OTOMATIS 02/02/2021 16:05 FLAZZ 885000750597 TRANSJOGJA-HO 20210201EPB5338006 7013000 ","0998","13,500.00 CR","509,405,905.65"
"02/02","KR OTOMATIS 02/02/2021 16:05 FLAZZ 885000750597 TRANSJOGJA-HO 20210201EPB5338504 3013000 ","0998","2,700.00 CR","509,408,605.65"
"02/02","KR OTOMATIS 02/02/2021 16:05 FLAZZ 885000750597 TRANSJOGJA-HO 20210201EPB5339600 9013000 ","0998","2,700.00 CR","509,411,305.65"
"02/02","KR OTOMATIS 02/02/2021 16:05 FLAZZ 885000750597 TRANSJOGJA-HO 20210201EPB5339701 2013000 ","0998","5,400.00 CR","509,416,705.65"
"03/02","KR OTOMATIS 03/02/2021 16:05 FLAZZ 885000750597 TRANSJOGJA-HO 20210202EPB0741907 3013000 ","0998","5,400.00 CR","509,422,105.65"
"03/02","KR OTOMATIS 03/02/2021 16:05 FLAZZ 885000750597 TRANSJOGJA-HO 20210202EPB0742901 0013000 ","0998","2,700.00 CR","509,424,805.65"
"03/02","KR OTOMATIS 03/02/2021 16:05 FLAZZ 885000750597 TRANSJOGJA-HO 20210202EPB0743901 1013000 ","0998","2,700.00 CR","509,427,505.65"
"03/02","KR OTOMATIS 03/02/2021 16:05 FLAZZ 885000750597 TRANSJOGJA-HO 20210202EPB0744201 9013000 ","0998","2,700.00 CR","509,430,205.65"
"03/02","KR OTOMATIS 03/02/2021 16:05 FLAZZ 885000750597 TRANSJOGJA-HO 20210202EPB0744703 3013000 ","0998","2,700.00 CR","509,432,905.65"
"03/02","KR OTOMATIS 03/02/2021 16:05 FLAZZ 885000750597 TRANSJOGJA-HO 20210202EPB1311701 8013000 ","0998","10,800.00 CR","509,443,705.65"
"03/02","KR OTOMATIS 03/02/2021 16:05 FLAZZ 885000750597 TRANSJOGJA-HO 20210202EPB1314703 0013000 ","0998","5,400.00 CR","509,449,105.65"
"03/02","KR OTOMATIS 03/02/2021 16:05 FLAZZ 885000750597 TRANSJOGJA-HO 20210202EPB4764501 1013000 ","0998","2,700.00 CR","509,451,805.65"
"03/02","KR OTOMATIS 03/02/2021 16:05 FLAZZ 885000750597 TRANSJOGJA-HO 20210202EPB5336101 2013000 ","0998","2,700.00 CR","509,454,505.65"
"03/02","KR OTOMATIS 03/02/2021 16:05 FLAZZ 885000750597 TRANSJOGJA-HO 20210202EPB5337604 5013000 ","0998","5,400.00 CR","509,459,905.65"
"03/02","KR OTOMATIS 03/02/2021 16:05 FLAZZ 885000750597 TRANSJOGJA-HO 20210202EPB5338006 8013000 ","0998","10,800.00 CR","509,470,705.65"
"03/02","KR OTOMATIS 03/02/2021 16:05 FLAZZ 885000750597 TRANSJOGJA-HO 20210202EPB5339402 3013000 ","0998","2,700.00 CR","509,473,405.65"
"03/02","KR OTOMATIS 03/02/2021 16:05 FLAZZ 885000750597 TRANSJOGJA-HO 20210202EPB5373400 9013000 ","0998","2,700.00 CR","509,476,105.65"
"03/02","KR OTOMATIS 03/02/2021 16:05 FLAZZ 885000750597 TRANSJOGJA-HO 20210202EPB0742201 7013000 ","0998","13,500.00 CR","509,489,605.65"
"03/02","KR OTOMATIS 03/02/2021 16:05 FLAZZ 885000750597 TRANSJOGJA-HO 20210202EPB0742601 0013000 ","0998","2,700.00 CR","509,492,305.65"
"03/02","KR OTOMATIS 03/02/2021 16:05 FLAZZ 885000750597 TRANSJOGJA-HO 20210202EPB0743306 4013000 ","0998","5,400.00 CR","509,497,705.65"
"03/02","KR OTOMATIS 03/02/2021 16:05 FLAZZ 885000750597 TRANSJOGJA-HO 20210202EPB0744000 7013000 ","0998","2,700.00 CR","509,500,405.65"
"03/02","KR OTOMATIS 03/02/2021 16:05 FLAZZ 885000750597 TRANSJOGJA-HO 20210202EPB0744401 8013000 ","0998","2,700.00 CR","509,503,105.65"
"03/02","KR OTOMATIS 03/02/2021 16:05 FLAZZ 885000750597 TRANSJOGJA-HO 20210202EPB1314201 7013000 ","0998","2,700.00 CR","509,505,805.65"
"03/02","KR OTOMATIS 03/02/2021 16:05 FLAZZ 885000750597 TRANSJOGJA-HO 20210202EPB1314802 6013000 ","0998","2,700.00 CR","509,508,505.65"
"03/02","KR OTOMATIS 03/02/2021 16:05 FLAZZ 885000750597 TRANSJOGJA-HO 20210202EPB4765001 2013000 ","0998","2,700.00 CR","509,511,205.65"
"03/02","KR OTOMATIS 03/02/2021 16:05 FLAZZ 885000750597 TRANSJOGJA-HO 20210202EPB5336400 5013000 ","0998","2,700.00 CR","509,513,905.65"
"03/02","KR OTOMATIS 03/02/2021 16:05 FLAZZ 885000750597 TRANSJOGJA-HO 20210202EPB5336601 9013000 ","0998","5,400.00 CR","509,519,305.65"
"03/02","KR OTOMATIS 03/02/2021 16:05 FLAZZ 885000750597 TRANSJOGJA-HO 20210202EPB5338207 1013000 ","0998","10,800.00 CR","509,530,105.65"
"03/02","KR OTOMATIS 03/02/2021 16:05 FLAZZ 885000750597 TRANSJOGJA-HO 20210202EPB5339902 0013000 ","0998","8,100.00 CR","509,538,205.65"
"04/02","KR OTOMATIS 04/02/2021 16:05 FLAZZ 885000750597 TRANSJOGJA-HO 20210203EPB0741601 5013000 ","0998","5,400.00 CR","509,543,605.65"
"04/02","KR OTOMATIS 04/02/2021 16:05 FLAZZ 885000750597 TRANSJOGJA-HO 20210203EPB0742402 1013000 ","0998","2,700.00 CR","509,546,305.65"
"04/02","KR OTOMATIS 04/02/2021 16:05 FLAZZ 885000750597 TRANSJOGJA-HO 20210203EPB0743306 5013000 ","0998","5,400.00 CR","509,551,705.65"
"04/02","KR OTOMATIS 04/02/2021 16:05 FLAZZ 885000750597 TRANSJOGJA-HO 20210203EPB0743600 4013000 ","0998","2,700.00 CR","509,554,405.65"
"04/02","KR OTOMATIS 04/02/2021 16:05 FLAZZ 885000750597 TRANSJOGJA-HO 20210203EPB0744703 4013000 ","0998","5,400.00 CR","509,559,805.65"
"04/02","KR OTOMATIS 04/02/2021 16:05 FLAZZ 885000750597 TRANSJOGJA-HO 20210203EPB1311701 9013000 ","0998","8,100.00 CR","509,567,905.65"
"04/02","KR OTOMATIS 04/02/2021 16:05 FLAZZ 885000750597 TRANSJOGJA-HO 20210203EPB1314401 7013000 ","0998","2,700.00 CR","509,570,605.65"
"04/02","KR OTOMATIS 04/02/2021 16:05 FLAZZ 885000750597 TRANSJOGJA-HO 20210203EPB1314802 7013000 ","0998","2,700.00 CR","509,573,305.65"
"04/02","KR OTOMATIS 04/02/2021 16:05 FLAZZ 885000750597 TRANSJOGJA-HO 20210203EPB4353106 8013000 ","0998","2,700.00 CR","509,576,005.65"
"04/02","KR OTOMATIS 04/02/2021 16:05 FLAZZ 885000750597 TRANSJOGJA-HO 20210203EPB5336501 0013000 ","0998","5,400.00 CR","509,581,405.65"
"04/02","KR OTOMATIS 04/02/2021 16:05 FLAZZ 885000750597 TRANSJOGJA-HO 20210203EPB5337001 6013000 ","0998","2,700.00 CR","509,584,105.65"
"04/02","KR OTOMATIS 04/02/2021 16:05 FLAZZ 885000750597 TRANSJOGJA-HO 20210203EPB5338006 9013000 ","0998","8,100.00 CR","509,592,205.65"
"04/02","KR OTOMATIS 04/02/2021 16:05 FLAZZ 885000750597 TRANSJOGJA-HO 20210203EPB5338504 4013000 ","0998","13,500.00 CR","509,605,705.65"
"04/02","KR OTOMATIS 04/02/2021 16:05 FLAZZ 885000750597 TRANSJOGJA-HO 20210203EPB5339601 0013000 ","0998","2,700.00 CR","509,608,405.65"
"04/02","KR OTOMATIS 04/02/2021 16:05 FLAZZ 885000750597 TRANSJOGJA-HO 20210203EPB5339803 1013000 ","0998","5,400.00 CR","509,613,805.65"
"04/02","KR OTOMATIS 04/02/2021 16:05 FLAZZ 885000750597 TRANSJOGJA-HO 20210203EPB0741907 4013000 ","0998","8,100.00 CR","509,621,905.65"
"04/02","KR OTOMATIS 04/02/2021 16:05 FLAZZ 885000750597 TRANSJOGJA-HO 20210203EPB0742201 8013000 ","0998","5,400.00 CR","509,627,305.65"
"04/02","KR OTOMATIS 04/02/2021 16:05 FLAZZ 885000750597 TRANSJOGJA-HO 20210203EPB0742801 2013000 ","0998","2,700.00 CR","509,630,005.65"
"04/02","KR OTOMATIS 04/02/2021 16:05 FLAZZ 885000750597 TRANSJOGJA-HO 20210203EPB0743700 9013000 ","0998","2,700.00 CR","509,632,705.65"
"04/02","KR OTOMATIS 04/02/2021 16:05 FLAZZ 885000750597 TRANSJOGJA-HO 20210203EPB0744202 0013000 ","0998","5,400.00 CR","509,638,105.65"
"04/02","KR OTOMATIS 04/02/2021 16:05 FLAZZ 885000750597 TRANSJOGJA-HO 20210203EPB1313900 9013000 ","0998","2,700.00 CR","509,640,805.65"
"04/02","KR OTOMATIS 04/02/2021 16:05 FLAZZ 885000750597 TRANSJOGJA-HO 20210203EPB1314201 8013000 ","0998","2,700.00 CR","509,643,505.65"
"04/02","KR OTOMATIS 04/02/2021 16:05 FLAZZ 885000750597 TRANSJOGJA-HO 20210203EPB1314703 1013000 ","0998","2,700.00 CR","509,646,205.65"
"04/02","KR OTOMATIS 04/02/2021 16:05 FLAZZ 885000750597 TRANSJOGJA-HO 20210203EPB3501701 0013000 ","0998","2,700.00 CR","509,648,905.65"
"04/02","KR OTOMATIS 04/02/2021 16:05 FLAZZ 885000750597 TRANSJOGJA-HO 20210203EPB5336602 0013000 ","0998","2,700.00 CR","509,651,605.65"
"04/02","KR OTOMATIS 04/02/2021 16:05 FLAZZ 885000750597 TRANSJOGJA-HO 20210203EPB5337302 0013000 ","0998","5,400.00 CR","509,657,005.65"
"04/02","KR OTOMATIS 04/02/2021 16:05 FLAZZ 885000750597 TRANSJOGJA-HO 20210203EPB5337700 8013000 ","0998","2,700.00 CR","509,659,705.65"
"04/02","KR OTOMATIS 04/02/2021 16:05 FLAZZ 885000750597 TRANSJOGJA-HO 20210203EPB5338207 2013000 ","0998","8,100.00 CR","509,667,805.65"
"04/02","KR OTOMATIS 04/02/2021 16:05 FLAZZ 885000750597 TRANSJOGJA-HO 20210203EPB5339502 1013000 ","0998","2,700.00 CR","509,670,505.65"
"04/02","KR OTOMATIS 04/02/2021 16:05 FLAZZ 885000750597 TRANSJOGJA-HO 20210203EPB5339701 3013000 ","0998","2,700.00 CR","509,673,205.65"
"05/02","KR OTOMATIS 05/02/2021 16:05 FLAZZ 885000750597 TRANSJOGJA-HO 20210204EPB0741907 5013000 ","0998","10,800.00 CR","509,684,005.65"
"05/02","KR OTOMATIS 05/02/2021 16:05 FLAZZ 885000750597 TRANSJOGJA-HO 20210204EPB0742706 2013000 ","0998","5,400.00 CR","509,689,405.65"
"05/02","KR OTOMATIS 05/02/2021 16:05 FLAZZ 885000750597 TRANSJOGJA-HO 20210204EPB0743306 6013000 ","0998","2,700.00 CR","509,692,105.65"
"05/02","KR OTOMATIS 05/02/2021 16:05 FLAZZ 885000750597 TRANSJOGJA-HO 20210204EPB0745001 6013000 ","0998","2,700.00 CR","509,694,805.65"
"05/02","KR OTOMATIS 05/02/2021 16:05 FLAZZ 885000750597 TRANSJOGJA-HO 20210204EPB1311800 8013000 ","0998","5,400.00 CR","509,700,205.65"
"05/02","KR OTOMATIS 05/02/2021 16:05 FLAZZ 885000750597 TRANSJOGJA-HO 20210204EPB4353106 9013000 ","0998","2,700.00 CR","509,702,905.65"
"05/02","KR OTOMATIS 05/02/2021 16:05 FLAZZ 885000750597 TRANSJOGJA-HO 20210204EPB5336101 3013000 ","0998","2,700.00 CR","509,705,605.65"
"05/02","KR OTOMATIS 05/02/2021 16:05 FLAZZ 885000750597 TRANSJOGJA-HO 20210204EPB5339402 4013000 ","0998","8,100.00 CR","509,713,705.65"
"05/02","KR OTOMATIS 05/02/2021 16:05 FLAZZ 885000750597 TRANSJOGJA-HO 20210204EPB5339902 1013000 ","0998","2,700.00 CR","509,716,405.65"
"05/02","KR OTOMATIS 05/02/2021 16:05 FLAZZ 885000750597 TRANSJOGJA-HO 20210204EPB0741301 1013000 ","0998","2,700.00 CR","509,719,105.65"
"05/02","KR OTOMATIS 05/02/2021 16:05 FLAZZ 885000750597 TRANSJOGJA-HO 20210204EPB0742201 9013000 ","0998","5,400.00 CR","509,724,505.65"
"05/02","KR OTOMATIS 05/02/2021 16:05 FLAZZ 885000750597 TRANSJOGJA-HO 20210204EPB0744301 0013000 ","0998","2,700.00 CR","509,727,205.65"
"05/02","KR OTOMATIS 05/02/2021 16:05 FLAZZ 885000750597 TRANSJOGJA-HO 20210204EPB1314703 2013000 ","0998","2,700.00 CR","509,729,905.65"
"05/02","KR OTOMATIS 05/02/2021 16:05 FLAZZ 885000750597 TRANSJOGJA-HO 20210204EPB4765001 3013000 ","0998","2,700.00 CR","509,732,605.65"
"05/02","KR OTOMATIS 05/02/2021 16:05 FLAZZ 885000750597 TRANSJOGJA-HO 20210204EPB5336501 1013000 ","0998","5,400.00 CR","509,738,005.65"
"05/02","KR OTOMATIS 05/02/2021 16:05 FLAZZ 885000750597 TRANSJOGJA-HO 20210204EPB5336802 5013000 ","0998","5,400.00 CR","509,743,405.65"
"05/02","KR OTOMATIS 05/02/2021 16:05 FLAZZ 885000750597 TRANSJOGJA-HO 20210204EPB5337302 1013000 ","0998","2,700.00 CR","509,746,105.65"
"05/02","KR OTOMATIS 05/02/2021 16:05 FLAZZ 885000750597 TRANSJOGJA-HO 20210204EPB5338100 6013000 ","0998","2,700.00 CR","509,748,805.65"
"05/02","KR OTOMATIS 05/02/2021 16:05 FLAZZ 885000750597 TRANSJOGJA-HO 20210204EPB5338207 3013000 ","0998","2,700.00 CR","509,751,505.65"
"05/02","KR OTOMATIS 05/02/2021 16:05 FLAZZ 885000750597 TRANSJOGJA-HO 20210204EPB5338504 5013000 ","0998","8,100.00 CR","509,759,605.65"
"05/02","KR OTOMATIS 05/02/2021 16:05 FLAZZ 885000750597 TRANSJOGJA-HO 20210204EPB5338900 5013000 ","0998","2,700.00 CR","509,762,305.65"
"05/02","KR OTOMATIS 05/02/2021 16:05 FLAZZ 885000750597 TRANSJOGJA-HO 20210204EPB5339000 3013000 ","0998","2,700.00 CR","509,765,005.65"
"05/02","KR OTOMATIS 05/02/2021 16:05 FLAZZ 885000750597 TRANSJOGJA-HO 20210204EPB5339102 3013000 ","0998","2,700.00 CR","509,767,705.65"
"05/02","KR OTOMATIS 05/02/2021 16:05 FLAZZ 885000750597 TRANSJOGJA-HO 20210204EPB5373302 1013000 ","0998","10,800.00 CR","509,778,505.65"
"08/02","KR OTOMATIS 08/02/2021 16:05 FLAZZ 885000750597 TRANSJOGJA-HO 20210205EPB0741301 2013000 ","0998","2,700.00 CR","509,781,205.65"
"08/02","KR OTOMATIS 08/02/2021 16:05 FLAZZ 885000750597 TRANSJOGJA-HO 20210205EPB0742706 3013000 ","0998","5,400.00 CR","509,786,605.65"
"08/02","KR OTOMATIS 08/02/2021 16:05 FLAZZ 885000750597 TRANSJOGJA-HO 20210205EPB0743001 1013000 ","0998","2,700.00 CR","509,789,305.65"
"08/02","KR OTOMATIS 08/02/2021 16:05 FLAZZ 885000750597 TRANSJOGJA-HO 20210205EPB0743306 7013000 ","0998","10,800.00 CR","509,800,105.65"
"08/02","KR OTOMATIS 08/02/2021 16:05 FLAZZ 885000750597 TRANSJOGJA-HO 20210205EPB0744202 1013000 ","0998","2,700.00 CR","509,802,805.65"
"08/02","KR OTOMATIS 08/02/2021 16:05 FLAZZ 885000750597 TRANSJOGJA-HO 20210205EPB1314802 8013000 ","0998","2,700.00 CR","509,805,505.65"
"08/02","KR OTOMATIS 08/02/2021 16:05 FLAZZ 885000750597 TRANSJOGJA-HO 20210205EPB5336300 7013000 ","0998","5,400.00 CR","509,810,905.65"
"08/02","KR OTOMATIS 08/02/2021 16:05 FLAZZ 885000750597 TRANSJOGJA-HO 20210205EPB5336602 1013000 ","0998","5,400.00 CR","509,816,305.65"
"08/02","KR OTOMATIS 08/02/2021 16:05 FLAZZ 885000750597 TRANSJOGJA-HO 20210205EPB5337001 7013000 ","0998","2,700.00 CR","509,819,005.65"
"08/02","KR OTOMATIS 08/02/2021 16:05 FLAZZ 885000750597 TRANSJOGJA-HO 20210205EPB5337302 2013000 ","0998","2,700.00 CR","509,821,705.65"
"08/02","KR OTOMATIS 08/02/2021 16:05 FLAZZ 885000750597 TRANSJOGJA-HO 20210205EPB5337604 6013000 ","0998","2,700.00 CR","509,824,405.65"
"08/02","KR OTOMATIS 08/02/2021 16:05 FLAZZ 885000750597 TRANSJOGJA-HO 20210205EPB5338504 6013000 ","0998","2,700.00 CR","509,827,105.65"
"08/02","KR OTOMATIS 08/02/2021 16:05 FLAZZ 885000750597 TRANSJOGJA-HO 20210205EPB5339402 5013000 ","0998","5,400.00 CR","509,832,505.65"
"08/02","KR OTOMATIS 08/02/2021 16:05 FLAZZ 885000750597 TRANSJOGJA-HO 20210205EPB5373302 2013000 ","0998","5,400.00 CR","509,837,905.65"
"08/02","KR OTOMATIS 08/02/2021 16:05 FLAZZ 885000750597 TRANSJOGJA-HO 20210206EPB0741802 8013000 ","0998","2,700.00 CR","509,840,605.65"
"08/02","KR OTOMATIS 08/02/2021 16:05 FLAZZ 885000750597 TRANSJOGJA-HO 20210206EPB0742706 4013000 ","0998","2,700.00 CR","509,843,305.65"
"08/02","KR OTOMATIS 08/02/2021 16:05 FLAZZ 885000750597 TRANSJOGJA-HO 20210206EPB0743402 1013000 ","0998","2,700.00 CR","509,846,005.65"
"08/02","KR OTOMATIS 08/02/2021 16:05 FLAZZ 885000750597 TRANSJOGJA-HO 20210206EPB0745100 9013000 ","0998","5,400.00 CR","509,851,405.65"
"08/02","KR OTOMATIS 08/02/2021 16:05 FLAZZ 885000750597 TRANSJOGJA-HO 20210206EPB1314703 4013000 ","0998","2,700.00 CR","509,854,105.65"
"08/02","KR OTOMATIS 08/02/2021 16:05 FLAZZ 885000750597 TRANSJOGJA-HO 20210206EPB4353107 1013000 ","0998","8,100.00 CR","509,862,205.65"
"08/02","KR OTOMATIS 08/02/2021 16:05 FLAZZ 885000750597 TRANSJOGJA-HO 20210206EPB5337200 3013000 ","0998","5,400.00 CR","509,867,605.65"
"08/02","KR OTOMATIS 08/02/2021 16:05 FLAZZ 885000750597 TRANSJOGJA-HO 20210206EPB5338207 5013000 ","0998","2,700.00 CR","509,870,305.65"
"08/02","KR OTOMATIS 08/02/2021 16:05 FLAZZ 885000750597 TRANSJOGJA-HO 20210206EPB5338504 7013000 ","0998","2,700.00 CR","509,873,005.65"
"08/02","KR OTOMATIS 08/02/2021 16:05 FLAZZ 885000750597 TRANSJOGJA-HO 20210206EPB5338900 6013000 ","0998","2,700.00 CR","509,875,705.65"
"08/02","KR OTOMATIS 08/02/2021 16:05 FLAZZ 885000750597 TRANSJOGJA-HO 20210206EPB5339902 2013000 ","0998","2,700.00 CR","509,878,405.65"
"08/02","KR OTOMATIS 08/02/2021 16:05 FLAZZ 885000750597 TRANSJOGJA-HO 20210207EPB0741802 9013000 ","0998","5,400.00 CR","509,883,805.65"
"08/02","KR OTOMATIS 08/02/2021 16:05 FLAZZ 885000750597 TRANSJOGJA-HO 20210207EPB0742500 9013000 ","0998","2,700.00 CR","509,886,505.65"
"08/02","KR OTOMATIS 08/02/2021 16:05 FLAZZ 885000750597 TRANSJOGJA-HO 20210207EPB0744301 1013000 ","0998","5,400.00 CR","509,891,905.65"
"08/02","KR OTOMATIS 08/02/2021 16:05 FLAZZ 885000750597 TRANSJOGJA-HO 20210207EPB3501701 2013000 ","0998","5,400.00 CR","509,897,305.65"
"08/02","KR OTOMATIS 08/02/2021 16:05 FLAZZ 885000750597 TRANSJOGJA-HO 20210207EPB5337200 4013000 ","0998","29,700.00 CR","509,927,005.65"
"08/02","KR OTOMATIS 08/02/2021 16:05 FLAZZ 885000750597 TRANSJOGJA-HO 20210207EPB5338207 6013000 ","0998","18,900.00 CR","509,945,905.65"
"08/02","KR OTOMATIS 08/02/2021 16:05 FLAZZ 885000750597 TRANSJOGJA-HO 20210207EPB5339102 5013000 ","0998","2,700.00 CR","509,948,605.65"
"08/02","KR OTOMATIS 08/02/2021 16:05 FLAZZ 885000750597 TRANSJOGJA-HO 20210205EPB0742100 3013000 ","0998","2,700.00 CR","509,951,305.65"
"08/02","KR OTOMATIS 08/02/2021 16:05 FLAZZ 885000750597 TRANSJOGJA-HO 20210205EPB0742901 1013000 ","0998","2,700.00 CR","509,954,005.65"
"08/02","KR OTOMATIS 08/02/2021 16:05 FLAZZ 885000750597 TRANSJOGJA-HO 20210205EPB0743200 5013000 ","0998","2,700.00 CR","509,956,705.65"
"08/02","KR OTOMATIS 08/02/2021 16:05 FLAZZ 885000750597 TRANSJOGJA-HO 20210205EPB0743701 0013000 ","0998","2,700.00 CR","509,959,405.65"
"08/02","KR OTOMATIS 08/02/2021 16:05 FLAZZ 885000750597 TRANSJOGJA-HO 20210205EPB1314201 9013000 ","0998","2,700.00 CR","509,962,105.65"
"08/02","KR OTOMATIS 08/02/2021 16:05 FLAZZ 885000750597 TRANSJOGJA-HO 20210205EPB1314703 3013000 ","0998","2,700.00 CR","509,964,805.65"
"08/02","KR OTOMATIS 08/02/2021 16:05 FLAZZ 885000750597 TRANSJOGJA-HO 20210205EPB4353107 0013000 ","0998","2,700.00 CR","509,967,505.65"
"08/02","KR OTOMATIS 08/02/2021 16:05 FLAZZ 885000750597 TRANSJOGJA-HO 20210205EPB5336501 2013000 ","0998","2,700.00 CR","509,970,205.65"
"08/02","KR OTOMATIS 08/02/2021 16:05 FLAZZ 885000750597 TRANSJOGJA-HO 20210205EPB5336802 6013000 ","0998","5,400.00 CR","509,975,605.65"
"08/02","KR OTOMATIS 08/02/2021 16:05 FLAZZ 885000750597 TRANSJOGJA-HO 20210205EPB5337103 3013000 ","0998","2,700.00 CR","509,978,305.65"
"08/02","KR OTOMATIS 08/02/2021 16:05 FLAZZ 885000750597 TRANSJOGJA-HO 20210205EPB5337200 2013000 ","0998","18,900.00 CR","509,997,205.65"
"08/02","KR OTOMATIS 08/02/2021 16:05 FLAZZ 885000750597 TRANSJOGJA-HO 20210205EPB5338207 4013000 ","0998","5,400.00 CR","510,002,605.65"
"08/02","KR OTOMATIS 08/02/2021 16:05 FLAZZ 885000750597 TRANSJOGJA-HO 20210205EPB5339203 0013000 ","0998","2,700.00 CR","510,005,305.65"
"08/02","KR OTOMATIS 08/02/2021 16:05 FLAZZ 885000750597 TRANSJOGJA-HO 20210205EPB5339701 4013000 ","0998","2,700.00 CR","510,008,005.65"
"08/02","KR OTOMATIS 08/02/2021 16:05 FLAZZ 885000750597 TRANSJOGJA-HO 20210206EPB0741301 3013000 ","0998","2,700.00 CR","510,010,705.65"
"08/02","KR OTOMATIS 08/02/2021 16:05 FLAZZ 885000750597 TRANSJOGJA-HO 20210206EPB0742202 0013000 ","0998","5,400.00 CR","510,016,105.65"
"08/02","KR OTOMATIS 08/02/2021 16:05 FLAZZ 885000750597 TRANSJOGJA-HO 20210206EPB0743001 2013000 ","0998","2,700.00 CR","510,018,805.65"
"08/02","KR OTOMATIS 08/02/2021 16:05 FLAZZ 885000750597 TRANSJOGJA-HO 20210206EPB0744500 7013000 ","0998","2,700.00 CR","510,021,505.65"
"08/02","KR OTOMATIS 08/02/2021 16:05 FLAZZ 885000750597 TRANSJOGJA-HO 20210206EPB1314401 8013000 ","0998","2,700.00 CR","510,024,205.65"
"08/02","KR OTOMATIS 08/02/2021 16:05 FLAZZ 885000750597 TRANSJOGJA-HO 20210206EPB3501701 1013000 ","0998","2,700.00 CR","510,026,905.65"
"08/02","KR OTOMATIS 08/02/2021 16:05 FLAZZ 885000750597 TRANSJOGJA-HO 20210206EPB4764501 2013000 ","0998","5,400.00 CR","510,032,305.65"
"08/02","KR OTOMATIS 08/02/2021 16:05 FLAZZ 885000750597 TRANSJOGJA-HO 20210206EPB5337604 7013000 ","0998","8,100.00 CR","510,040,405.65"
"08/02","KR OTOMATIS 08/02/2021 16:05 FLAZZ 885000750597 TRANSJOGJA-HO 20210206EPB5338007 0013000 ","0998","2,700.00 CR","510,043,105.65"
"08/02","KR OTOMATIS 08/02/2021 16:05 FLAZZ 885000750597 TRANSJOGJA-HO 20210206EPB5338301 8013000 ","0998","2,700.00 CR","510,045,805.65"
"08/02","KR OTOMATIS 08/02/2021 16:05 FLAZZ 885000750597 TRANSJOGJA-HO 20210206EPB5338701 4013000 ","0998","2,700.00 CR","510,048,505.65"
"08/02","KR OTOMATIS 08/02/2021 16:05 FLAZZ 885000750597 TRANSJOGJA-HO 20210206EPB5339102 4013000 ","0998","2,700.00 CR","510,051,205.65"
"08/02","KR OTOMATIS 08/02/2021 16:05 FLAZZ 885000750597 TRANSJOGJA-HO 20210206EPB5373302 3013000 ","0998","2,700.00 CR","510,053,905.65"
"08/02","KR OTOMATIS 08/02/2021 16:05 FLAZZ 885000750597 TRANSJOGJA-HO 20210207EPB0742202 1013000 ","0998","5,400.00 CR","510,059,305.65"
"08/02","KR OTOMATIS 08/02/2021 16:05 FLAZZ 885000750597 TRANSJOGJA-HO 20210207EPB0743306 8013000 ","0998","10,800.00 CR","510,070,105.65"
"08/02","KR OTOMATIS 08/02/2021 16:05 FLAZZ 885000750597 TRANSJOGJA-HO 20210207EPB1314000 8013000 ","0998","2,700.00 CR","510,072,805.65"
"08/02","KR OTOMATIS 08/02/2021 16:05 FLAZZ 885000750597 TRANSJOGJA-HO 20210207EPB4353107 2013000 ","0998","5,400.00 CR","510,078,205.65"
"08/02","KR OTOMATIS 08/02/2021 16:05 FLAZZ 885000750597 TRANSJOGJA-HO 20210207EPB5336101 4013000 ","0998","8,100.00 CR","510,086,305.65"
"08/02","KR OTOMATIS 08/02/2021 16:05 FLAZZ 885000750597 TRANSJOGJA-HO 20210207EPB5337604 8013000 ","0998","2,700.00 CR","510,089,005.65"
"08/02","KR OTOMATIS 08/02/2021 16:05 FLAZZ 885000750597 TRANSJOGJA-HO 20210207EPB5339203 1013000 ","0998","2,700.00 CR","510,091,705.65"
"09/02","KR OTOMATIS 09/02/2021 16:05 FLAZZ 885000750597 TRANSJOGJA-HO 20210208EPB0741301 4013000 ","0998","2,700.00 CR","510,094,405.65"
"09/02","KR OTOMATIS 09/02/2021 16:05 FLAZZ 885000750597 TRANSJOGJA-HO 20210208EPB0741601 6013000 ","0998","2,700.00 CR","510,097,105.65"
"09/02","KR OTOMATIS 09/02/2021 16:05 FLAZZ 885000750597 TRANSJOGJA-HO 20210208EPB0741702 3013000 ","0998","8,100.00 CR","510,105,205.65"
"09/02","KR OTOMATIS 09/02/2021 16:05 FLAZZ 885000750597 TRANSJOGJA-HO 20210208EPB0742202 2013000 ","0998","10,800.00 CR","510,116,005.65"
"09/02","KR OTOMATIS 09/02/2021 16:05 FLAZZ 885000750597 TRANSJOGJA-HO 20210208EPB1314401 9013000 ","0998","2,700.00 CR","510,118,705.65"
"09/02","KR OTOMATIS 09/02/2021 16:05 FLAZZ 885000750597 TRANSJOGJA-HO 20210208EPB5337103 4013000 ","0998","5,400.00 CR","510,124,105.65"
"09/02","KR OTOMATIS 09/02/2021 16:05 FLAZZ 885000750597 TRANSJOGJA-HO 20210208EPB5337604 9013000 ","0998","5,400.00 CR","510,129,505.65"
"09/02","KR OTOMATIS 09/02/2021 16:05 FLAZZ 885000750597 TRANSJOGJA-HO 20210208EPB5337802 0013000 ","0998","5,400.00 CR","510,134,905.65"
"09/02","KR OTOMATIS 09/02/2021 16:05 FLAZZ 885000750597 TRANSJOGJA-HO 20210208EPB5338207 7013000 ","0998","5,400.00 CR","510,140,305.65"
"09/02","KR OTOMATIS 09/02/2021 16:05 FLAZZ 885000750597 TRANSJOGJA-HO 20210208EPB5338301 9013000 ","0998","2,700.00 CR","510,143,005.65"
"09/02","KR OTOMATIS 09/02/2021 16:05 FLAZZ 885000750597 TRANSJOGJA-HO 20210208EPB5338504 8013000 ","0998","2,700.00 CR","510,145,705.65"
"09/02","KR OTOMATIS 09/02/2021 16:05 FLAZZ 885000750597 TRANSJOGJA-HO 20210208EPB5339701 5013000 ","0998","5,400.00 CR","510,151,105.65"
"09/02","KR OTOMATIS 09/02/2021 16:05 FLAZZ 885000750597 TRANSJOGJA-HO 20210208EPB5339803 2013000 ","0998","2,700.00 CR","510,153,805.65"
"09/02","KR OTOMATIS 09/02/2021 16:05 FLAZZ 885000750597 TRANSJOGJA-HO 20210208EPB0741501 3013000 ","0998","2,700.00 CR","510,156,505.65"
"09/02","KR OTOMATIS 09/02/2021 16:05 FLAZZ 885000750597 TRANSJOGJA-HO 20210208EPB0741803 0013000 ","0998","2,700.00 CR","510,159,205.65"
"09/02","KR OTOMATIS 09/02/2021 16:05 FLAZZ 885000750597 TRANSJOGJA-HO 20210208EPB0742706 5013000 ","0998","13,500.00 CR","510,172,705.65"
"09/02","KR OTOMATIS 09/02/2021 16:05 FLAZZ 885000750597 TRANSJOGJA-HO 20210208EPB0743306 9013000 ","0998","2,700.00 CR","510,175,405.65"
"09/02","KR OTOMATIS 09/02/2021 16:05 FLAZZ 885000750597 TRANSJOGJA-HO 20210208EPB0743801 6013000 ","0998","2,700.00 CR","510,178,105.65"
"09/02","KR OTOMATIS 09/02/2021 16:05 FLAZZ 885000750597 TRANSJOGJA-HO 20210208EPB0743901 2013000 ","0998","2,700.00 CR","510,180,805.65"
"09/02","KR OTOMATIS 09/02/2021 16:05 FLAZZ 885000750597 TRANSJOGJA-HO 20210208EPB0744301 2013000 ","0998","2,700.00 CR","510,183,505.65"
"09/02","KR OTOMATIS 09/02/2021 16:05 FLAZZ 885000750597 TRANSJOGJA-HO 20210208EPB1314703 5013000 ","0998","2,700.00 CR","510,186,205.65"
"09/02","KR OTOMATIS 09/02/2021 16:05 FLAZZ 885000750597 TRANSJOGJA-HO 20210208EPB4353107 3013000 ","0998","5,400.00 CR","510,191,605.65"
"09/02","KR OTOMATIS 09/02/2021 16:05 FLAZZ 885000750597 TRANSJOGJA-HO 20210208EPB5338007 1013000 ","0998","5,400.00 CR","510,197,005.65"
"09/02","KR OTOMATIS 09/02/2021 16:05 FLAZZ 885000750597 TRANSJOGJA-HO 20210208EPB5338405 9013000 ","0998","5,400.00 CR","510,202,405.65"
"09/02","KR OTOMATIS 09/02/2021 16:05 FLAZZ 885000750597 TRANSJOGJA-HO 20210208EPB5339203 2013000 ","0998","2,700.00 CR","510,205,105.65"
"10/02","KR OTOMATIS 10/02/2021 16:05 FLAZZ 885000750597 TRANSJOGJA-HO 20210209EPB0741702 4013000 ","0998","2,700.00 CR","510,207,805.65"
"10/02","KR OTOMATIS 10/02/2021 16:05 FLAZZ 885000750597 TRANSJOGJA-HO 20210209EPB0743200 6013000 ","0998","2,700.00 CR","510,210,505.65"
"10/02","KR OTOMATIS 10/02/2021 16:05 FLAZZ 885000750597 TRANSJOGJA-HO 20210209EPB0743307 0013000 ","0998","8,100.00 CR","510,218,605.65"
"10/02","KR OTOMATIS 10/02/2021 16:05 FLAZZ 885000750597 TRANSJOGJA-HO 20210209EPB1313400 4013000 ","0998","2,700.00 CR","510,221,305.65"
"10/02","KR OTOMATIS 10/02/2021 16:05 FLAZZ 885000750597 TRANSJOGJA-HO 20210209EPB1314202 0013000 ","0998","5,400.00 CR","510,226,705.65"
"10/02","KR OTOMATIS 10/02/2021 16:05 FLAZZ 885000750597 TRANSJOGJA-HO 20210209EPB4764501 3013000 ","0998","2,700.00 CR","510,229,405.65"
"10/02","KR OTOMATIS 10/02/2021 16:05 FLAZZ 885000750597 TRANSJOGJA-HO 20210209EPB4767800 1013000 ","0998","2,700.00 CR","510,232,105.65"
"10/02","KR OTOMATIS 10/02/2021 16:05 FLAZZ 885000750597 TRANSJOGJA-HO 20210209EPB5336602 2013000 ","0998","2,700.00 CR","510,234,805.65"
"10/02","KR OTOMATIS 10/02/2021 16:05 FLAZZ 885000750597 TRANSJOGJA-HO 20210209EPB5336802 7013000 ","0998","2,700.00 CR","510,237,505.65"
"10/02","KR OTOMATIS 10/02/2021 16:05 FLAZZ 885000750597 TRANSJOGJA-HO 20210209EPB5337103 5013000 ","0998","2,700.00 CR","510,240,205.65"
"10/02","KR OTOMATIS 10/02/2021 16:05 FLAZZ 885000750597 TRANSJOGJA-HO 20210209EPB5337802 1013000 ","0998","2,700.00 CR","510,242,905.65"
"10/02","KR OTOMATIS 10/02/2021 16:05 FLAZZ 885000750597 TRANSJOGJA-HO 20210209EPB5338100 7013000 ","0998","2,700.00 CR","510,245,605.65"
"10/02","KR OTOMATIS 10/02/2021 16:05 FLAZZ 885000750597 TRANSJOGJA-HO 20210209EPB5338504 9013000 ","0998","2,700.00 CR","510,248,305.65"
"10/02","KR OTOMATIS 10/02/2021 16:05 FLAZZ 885000750597 TRANSJOGJA-HO 20210209EPB5339902 3013000 ","0998","2,700.00 CR","510,251,005.65"
"10/02","KR OTOMATIS 10/02/2021 16:05 FLAZZ 885000750597 TRANSJOGJA-HO 20210123EPB0741702 0013000 ","0998","8,100.00 CR","510,259,105.65"
"10/02","KR OTOMATIS 10/02/2021 16:05 FLAZZ 885000750597 TRANSJOGJA-HO 20210123EPB0742800 8013000 ","0998","5,400.00 CR","510,264,505.65"
"10/02","KR OTOMATIS 10/02/2021 16:05 FLAZZ 885000750597 TRANSJOGJA-HO 20210123EPB0743305 7013000 ","0998","5,400.00 CR","510,269,905.65"
"10/02","KR OTOMATIS 10/02/2021 16:05 FLAZZ 885000750597 TRANSJOGJA-HO 20210123EPB0744702 4013000 ","0998","5,400.00 CR","510,275,305.65"
"10/02","KR OTOMATIS 10/02/2021 16:05 FLAZZ 885000750597 TRANSJOGJA-HO 20210123EPB1310901 4013000 ","0998","5,400.00 CR","510,280,705.65"
"10/02","KR OTOMATIS 10/02/2021 16:05 FLAZZ 885000750597 TRANSJOGJA-HO 20210123EPB1314702 6013000 ","0998","5,400.00 CR","510,286,105.65"
"10/02","KR OTOMATIS 10/02/2021 16:05 FLAZZ 885000750597 TRANSJOGJA-HO 20210123EPB5336500 9013000 ","0998","5,400.00 CR","510,291,505.65"
"10/02","KR OTOMATIS 10/02/2021 16:05 FLAZZ 885000750597 TRANSJOGJA-HO 20210123EPB5337103 0013000 ","0998","2,700.00 CR","510,294,205.65"
"10/02","KR OTOMATIS 10/02/2021 16:05 FLAZZ 885000750597 TRANSJOGJA-HO 20210123EPB5338006 1013000 ","0998","8,100.00 CR","510,302,305.65"
"10/02","KR OTOMATIS 10/02/2021 16:05 FLAZZ 885000750597 TRANSJOGJA-HO 20210123EPB5338301 5013000 ","0998","5,400.00 CR","510,307,705.65"
"10/02","KR OTOMATIS 10/02/2021 16:05 FLAZZ 885000750597 TRANSJOGJA-HO 20210123EPB5339101 9013000 ","0998","5,400.00 CR","510,313,105.65"
"10/02","KR OTOMATIS 10/02/2021 16:05 FLAZZ 885000750597 TRANSJOGJA-HO 20210123EPB5373301 9013000 ","0998","5,400.00 CR","510,318,505.65"
"10/02","KR OTOMATIS 10/02/2021 16:05 FLAZZ 885000750597 TRANSJOGJA-HO 20210209EPB0741803 1013000 ","0998","2,700.00 CR","510,321,205.65"
"10/02","KR OTOMATIS 10/02/2021 16:05 FLAZZ 885000750597 TRANSJOGJA-HO 20210209EPB0742202 3013000 ","0998","10,800.00 CR","510,332,005.65"
"10/02","KR OTOMATIS 10/02/2021 16:05 FLAZZ 885000750597 TRANSJOGJA-HO 20210209EPB0742801 3013000 ","0998","2,700.00 CR","510,334,705.65"
"10/02","KR OTOMATIS 10/02/2021 16:05 FLAZZ 885000750597 TRANSJOGJA-HO 20210209EPB0743901 3013000 ","0998","2,700.00 CR","510,337,405.65"
"10/02","KR OTOMATIS 10/02/2021 16:05 FLAZZ 885000750597 TRANSJOGJA-HO 20210209EPB0744500 8013000 ","0998","2,700.00 CR","510,340,105.65"
"10/02","KR OTOMATIS 10/02/2021 16:05 FLAZZ 885000750597 TRANSJOGJA-HO 20210209EPB1314402 0013000 ","0998","2,700.00 CR","510,342,805.65"
"10/02","KR OTOMATIS 10/02/2021 16:05 FLAZZ 885000750597 TRANSJOGJA-HO 20210209EPB4353107 4013000 ","0998","13,500.00 CR","510,356,305.65"
"10/02","KR OTOMATIS 10/02/2021 16:05 FLAZZ 885000750597 TRANSJOGJA-HO 20210209EPB5336101 5013000 ","0998","2,700.00 CR","510,359,005.65"
"10/02","KR OTOMATIS 10/02/2021 16:05 FLAZZ 885000750597 TRANSJOGJA-HO 20210209EPB5336501 3013000 ","0998","2,700.00 CR","510,361,705.65"
"10/02","KR OTOMATIS 10/02/2021 16:05 FLAZZ 885000750597 TRANSJOGJA-HO 20210209EPB5336701 1013000 ","0998","5,400.00 CR","510,367,105.65"
"10/02","KR OTOMATIS 10/02/2021 16:05 FLAZZ 885000750597 TRANSJOGJA-HO 20210209EPB5337605 0013000 ","0998","10,800.00 CR","510,377,905.65"
"10/02","KR OTOMATIS 10/02/2021 16:05 FLAZZ 885000750597 TRANSJOGJA-HO 20210209EPB5338007 2013000 ","0998","10,800.00 CR","510,388,705.65"
"10/02","KR OTOMATIS 10/02/2021 16:05 FLAZZ 885000750597 TRANSJOGJA-HO 20210209EPB5338207 8013000 ","0998","8,100.00 CR","510,396,805.65"
"10/02","KR OTOMATIS 10/02/2021 16:05 FLAZZ 885000750597 TRANSJOGJA-HO 20210209EPB5339402 6013000 ","0998","2,700.00 CR","510,399,505.65"
"10/02","KR OTOMATIS 10/02/2021 16:05 FLAZZ 885000750597 TRANSJOGJA-HO 20210209EPB5339502 2013000 ","0998","2,700.00 CR","510,402,205.65"
"10/02","KR OTOMATIS 10/02/2021 16:05 FLAZZ 885000750597 TRANSJOGJA-HO 20210209EPB5373302 4013000 ","0998","2,700.00 CR","510,404,905.65"
"10/02","KR OTOMATIS 10/02/2021 16:05 FLAZZ 885000750597 TRANSJOGJA-HO 20210123EPB0741906 4013000 ","0998","10,800.00 CR","510,415,705.65"
"10/02","KR OTOMATIS 10/02/2021 16:05 FLAZZ 885000750597 TRANSJOGJA-HO 20210123EPB0742705 7013000 ","0998","10,800.00 CR","510,426,505.65"
"10/02","KR OTOMATIS 10/02/2021 16:05 FLAZZ 885000750597 TRANSJOGJA-HO 20210123EPB0743101 0013000 ","0998","2,700.00 CR","510,429,205.65"
"10/02","KR OTOMATIS 10/02/2021 16:05 FLAZZ 885000750597 TRANSJOGJA-HO 20210123EPB0744401 7013000 ","0998","5,400.00 CR","510,434,605.65"
"10/02","KR OTOMATIS 10/02/2021 16:05 FLAZZ 885000750597 TRANSJOGJA-HO 20210123EPB0745001 1013000 ","0998","2,700.00 CR","510,437,305.65"
"10/02","KR OTOMATIS 10/02/2021 16:05 FLAZZ 885000750597 TRANSJOGJA-HO 20210123EPB1311001 0013000 ","0998","5,400.00 CR","510,442,705.65"
"10/02","KR OTOMATIS 10/02/2021 16:05 FLAZZ 885000750597 TRANSJOGJA-HO 20210123EPB1314802 2013000 ","0998","2,700.00 CR","510,445,405.65"
"10/02","KR OTOMATIS 10/02/2021 16:05 FLAZZ 885000750597 TRANSJOGJA-HO 20210123EPB5337001 1013000 ","0998","10,800.00 CR","510,456,205.65"
"10/02","KR OTOMATIS 10/02/2021 16:05 FLAZZ 885000750597 TRANSJOGJA-HO 20210123EPB5337603 8013000 ","0998","2,700.00 CR","510,458,905.65"
"10/02","KR OTOMATIS 10/02/2021 16:05 FLAZZ 885000750597 TRANSJOGJA-HO 20210123EPB5338206 2013000 ","0998","8,100.00 CR","510,467,005.65"
"10/02","KR OTOMATIS 10/02/2021 16:05 FLAZZ 885000750597 TRANSJOGJA-HO 20210123EPB5338801 2013000 ","0998","5,400.00 CR","510,472,405.65"
"10/02","KR OTOMATIS 10/02/2021 16:05 FLAZZ 885000750597 TRANSJOGJA-HO 20210123EPB5339901 7013000 ","0998","5,400.00 CR","510,477,805.65"
"11/02","KR OTOMATIS 11/02/2021 16:05 FLAZZ 885000750597 TRANSJOGJA-HO 20210210EPB0741702 5013000 ","0998","5,400.00 CR","510,483,205.65"
"11/02","KR OTOMATIS 11/02/2021 16:05 FLAZZ 885000750597 TRANSJOGJA-HO 20210210EPB0742402 2013000 ","0998","2,700.00 CR","510,485,905.65"
"11/02","KR OTOMATIS 11/02/2021 16:05 FLAZZ 885000750597 TRANSJOGJA-HO 20210210EPB0742901 2013000 ","0998","2,700.00 CR","510,488,605.65"
"11/02","KR OTOMATIS 11/02/2021 16:05 FLAZZ 885000750597 TRANSJOGJA-HO 20210210EPB0743801 7013000 ","0998","2,700.00 CR","510,491,305.65"
"11/02","KR OTOMATIS 11/02/2021 16:05 FLAZZ 885000750597 TRANSJOGJA-HO 20210210EPB0744202 2013000 ","0998","2,700.00 CR","510,494,005.65"
"11/02","KR OTOMATIS 11/02/2021 16:05 FLAZZ 885000750597 TRANSJOGJA-HO 20210210EPB1311702 0013000 ","0998","2,700.00 CR","510,496,705.65"
"11/02","KR OTOMATIS 11/02/2021 16:05 FLAZZ 885000750597 TRANSJOGJA-HO 20210210EPB5336101 6013000 ","0998","2,700.00 CR","510,499,405.65"
"11/02","KR OTOMATIS 11/02/2021 16:05 FLAZZ 885000750597 TRANSJOGJA-HO 20210210EPB5336602 3013000 ","0998","8,100.00 CR","510,507,505.65"
"11/02","KR OTOMATIS 11/02/2021 16:05 FLAZZ 885000750597 TRANSJOGJA-HO 20210210EPB5337302 3013000 ","0998","2,700.00 CR","510,510,205.65"
"11/02","KR OTOMATIS 11/02/2021 16:05 FLAZZ 885000750597 TRANSJOGJA-HO 20210210EPB5337802 2013000 ","0998","2,700.00 CR","510,512,905.65"
"11/02","KR OTOMATIS 11/02/2021 16:05 FLAZZ 885000750597 TRANSJOGJA-HO 20210210EPB5375101 0013000 ","0998","2,700.00 CR","510,515,605.65"
"11/02","KR OTOMATIS 11/02/2021 16:05 FLAZZ 885000750597 TRANSJOGJA-HO 20210210EPB0741301 5013000 ","0998","5,400.00 CR","510,521,005.65"
"11/02","KR OTOMATIS 11/02/2021 16:05 FLAZZ 885000750597 TRANSJOGJA-HO 20210210EPB0741803 2013000 ","0998","2,700.00 CR","510,523,705.65"
"11/02","KR OTOMATIS 11/02/2021 16:05 FLAZZ 885000750597 TRANSJOGJA-HO 20210210EPB0742501 0013000 ","0998","2,700.00 CR","510,526,405.65"
"11/02","KR OTOMATIS 11/02/2021 16:05 FLAZZ 885000750597 TRANSJOGJA-HO 20210210EPB0743307 1013000 ","0998","10,800.00 CR","510,537,205.65"
"11/02","KR OTOMATIS 11/02/2021 16:05 FLAZZ 885000750597 TRANSJOGJA-HO 20210210EPB1310901 7013000 ","0998","2,700.00 CR","510,539,905.65"
"11/02","KR OTOMATIS 11/02/2021 16:05 FLAZZ 885000750597 TRANSJOGJA-HO 20210210EPB1314802 9013000 ","0998","2,700.00 CR","510,542,605.65"
"11/02","KR OTOMATIS 11/02/2021 16:05 FLAZZ 885000750597 TRANSJOGJA-HO 20210210EPB4353107 5013000 ","0998","8,100.00 CR","510,550,705.65"
"11/02","KR OTOMATIS 11/02/2021 16:05 FLAZZ 885000750597 TRANSJOGJA-HO 20210210EPB5336802 8013000 ","0998","2,700.00 CR","510,553,405.65"
"11/02","KR OTOMATIS 11/02/2021 16:05 FLAZZ 885000750597 TRANSJOGJA-HO 20210210EPB5337605 1013000 ","0998","5,400.00 CR","510,558,805.65"
"11/02","KR OTOMATIS 11/02/2021 16:05 FLAZZ 885000750597 TRANSJOGJA-HO 20210210EPB5339601 1013000 ","0998","2,700.00 CR","510,561,505.65"
"15/02","KR OTOMATIS 12/02/2021 16:05 FLAZZ 885000750597 TRANSJOGJA-HO 20210211EPB0741702 6013000 ","0998","10,800.00 CR","510,572,305.65"
"15/02","KR OTOMATIS 12/02/2021 16:05 FLAZZ 885000750597 TRANSJOGJA-HO 20210211EPB0742001 1013000 ","0998","2,700.00 CR","510,575,005.65"
"15/02","KR OTOMATIS 12/02/2021 16:05 FLAZZ 885000750597 TRANSJOGJA-HO 20210211EPB0743307 2013000 ","0998","8,100.00 CR","510,583,105.65"
"15/02","KR OTOMATIS 12/02/2021 16:05 FLAZZ 885000750597 TRANSJOGJA-HO 20210211EPB0743501 2013000 ","0998","2,700.00 CR","510,585,805.65"
"15/02","KR OTOMATIS 12/02/2021 16:05 FLAZZ 885000750597 TRANSJOGJA-HO 20210211EPB1311702 1013000 ","0998","2,700.00 CR","510,588,505.65"
"15/02","KR OTOMATIS 12/02/2021 16:05 FLAZZ 885000750597 TRANSJOGJA-HO 20210211EPB4767800 2013000 ","0998","2,700.00 CR","510,591,205.65"
"15/02","KR OTOMATIS 12/02/2021 16:05 FLAZZ 885000750597 TRANSJOGJA-HO 20210211EPB5336602 4013000 ","0998","5,400.00 CR","510,596,605.65"
"15/02","KR OTOMATIS 12/02/2021 16:05 FLAZZ 885000750597 TRANSJOGJA-HO 20210211EPB5337302 4013000 ","0998","2,700.00 CR","510,599,305.65"
"15/02","KR OTOMATIS 12/02/2021 16:05 FLAZZ 885000750597 TRANSJOGJA-HO 20210211EPB5338007 3013000 ","0998","5,400.00 CR","510,604,705.65"
"15/02","KR OTOMATIS 12/02/2021 16:05 FLAZZ 885000750597 TRANSJOGJA-HO 20210211EPB5338302 0013000 ","0998","2,700.00 CR","510,607,405.65"
"15/02","KR OTOMATIS 12/02/2021 16:05 FLAZZ 885000750597 TRANSJOGJA-HO 20210211EPB5339102 6013000 ","0998","5,400.00 CR","510,612,805.65"
"15/02","KR OTOMATIS 12/02/2021 16:05 FLAZZ 885000750597 TRANSJOGJA-HO 20210211EPB1314202 1013000 ","0998","2,700.00 CR","510,615,505.65"
"15/02","KR OTOMATIS 12/02/2021 16:05 FLAZZ 885000750597 TRANSJOGJA-HO 20210211EPB4765001 4013000 ","0998","5,400.00 CR","510,620,905.65"
"15/02","KR OTOMATIS 12/02/2021 16:05 FLAZZ 885000750597 TRANSJOGJA-HO 20210211EPB0741601 7013000 ","0998","5,400.00 CR","510,626,305.65"
"15/02","KR OTOMATIS 12/02/2021 16:05 FLAZZ 885000750597 TRANSJOGJA-HO 20210211EPB0741803 3013000 ","0998","5,400.00 CR","510,631,705.65"
"15/02","KR OTOMATIS 12/02/2021 16:05 FLAZZ 885000750597 TRANSJOGJA-HO 20210211EPB0742202 4013000 ","0998","16,200.00 CR","510,647,905.65"
"15/02","KR OTOMATIS 12/02/2021 16:05 FLAZZ 885000750597 TRANSJOGJA-HO 20210211EPB0743901 4013000 ","0998","2,700.00 CR","510,650,605.65"
"15/02","KR OTOMATIS 12/02/2021 16:05 FLAZZ 885000750597 TRANSJOGJA-HO 20210211EPB1313400 5013000 ","0998","2,700.00 CR","510,653,305.65"
"15/02","KR OTOMATIS 12/02/2021 16:05 FLAZZ 885000750597 TRANSJOGJA-HO 20210211EPB1313600 9013000 ","0998","2,700.00 CR","510,656,005.65"
"15/02","KR OTOMATIS 12/02/2021 16:05 FLAZZ 885000750597 TRANSJOGJA-HO 20210211EPB4353107 6013000 ","0998","10,800.00 CR","510,666,805.65"
"15/02","KR OTOMATIS 12/02/2021 16:05 FLAZZ 885000750597 TRANSJOGJA-HO 20210211EPB5336501 4013000 ","0998","5,400.00 CR","510,672,205.65"
"15/02","KR OTOMATIS 12/02/2021 16:05 FLAZZ 885000750597 TRANSJOGJA-HO 20210211EPB5336802 9013000 ","0998","2,700.00 CR","510,674,905.65"
"15/02","KR OTOMATIS 12/02/2021 16:05 FLAZZ 885000750597 TRANSJOGJA-HO 20210211EPB5337605 2013000 ","0998","13,500.00 CR","510,688,405.65"
"15/02","KR OTOMATIS 12/02/2021 16:05 FLAZZ 885000750597 TRANSJOGJA-HO 20210211EPB5338207 9013000 ","0998","5,400.00 CR","510,693,805.65"
"15/02","KR OTOMATIS 12/02/2021 16:05 FLAZZ 885000750597 TRANSJOGJA-HO 20210211EPB5338505 0013000 ","0998","5,400.00 CR","510,699,205.65"
"15/02","KR OTOMATIS 12/02/2021 16:05 FLAZZ 885000750597 TRANSJOGJA-HO 20210211EPB5338900 7013000 ","0998","2,700.00 CR","510,701,905.65"
"15/02","KR OTOMATIS 13/02/2021 16:05 FLAZZ 885000750597 TRANSJOGJA-HO 20210212EPB0741301 6013000 ","0998","2,700.00 CR","510,704,605.65"
"15/02","KR OTOMATIS 13/02/2021 16:05 FLAZZ 885000750597 TRANSJOGJA-HO 20210212EPB0741803 4013000 ","0998","2,700.00 CR","510,707,305.65"
"15/02","KR OTOMATIS 13/02/2021 16:05 FLAZZ 885000750597 TRANSJOGJA-HO 20210212EPB0742901 3013000 ","0998","2,700.00 CR","510,710,005.65"
"15/02","KR OTOMATIS 13/02/2021 16:05 FLAZZ 885000750597 TRANSJOGJA-HO 20210212EPB0743801 8013000 ","0998","2,700.00 CR","510,712,705.65"
"15/02","KR OTOMATIS 13/02/2021 16:05 FLAZZ 885000750597 TRANSJOGJA-HO 20210212EPB0744901 3013000 ","0998","5,400.00 CR","510,718,105.65"
"15/02","KR OTOMATIS 13/02/2021 16:05 FLAZZ 885000750597 TRANSJOGJA-HO 20210212EPB1314202 2013000 ","0998","2,700.00 CR","510,720,805.65"
"15/02","KR OTOMATIS 13/02/2021 16:05 FLAZZ 885000750597 TRANSJOGJA-HO 20210212EPB1314500 1013000 ","0998","10,800.00 CR","510,731,605.65"
"15/02","KR OTOMATIS 13/02/2021 16:05 FLAZZ 885000750597 TRANSJOGJA-HO 20210212EPB5336602 5013000 ","0998","2,700.00 CR","510,734,305.65"
"15/02","KR OTOMATIS 13/02/2021 16:05 FLAZZ 885000750597 TRANSJOGJA-HO 20210212EPB5337001 8013000 ","0998","13,500.00 CR","510,747,805.65"
"15/02","KR OTOMATIS 13/02/2021 16:05 FLAZZ 885000750597 TRANSJOGJA-HO 20210212EPB5338007 4013000 ","0998","2,700.00 CR","510,750,505.65"
"15/02","KR OTOMATIS 13/02/2021 16:05 FLAZZ 885000750597 TRANSJOGJA-HO 20210212EPB5338505 1013000 ","0998","5,400.00 CR","510,755,905.65"
"15/02","KR OTOMATIS 13/02/2021 16:05 FLAZZ 885000750597 TRANSJOGJA-HO 20210212EPB5339601 2013000 ","0998","5,400.00 CR","510,761,305.65"
"15/02","KR OTOMATIS 13/02/2021 16:05 FLAZZ 885000750597 TRANSJOGJA-HO 20210212EPB5339902 4013000 ","0998","2,700.00 CR","510,764,005.65"
"15/02","KR OTOMATIS 13/02/2021 16:05 FLAZZ 885000750597 TRANSJOGJA-HO 20210212EPB0745101 0013000 ","0998","8,100.00 CR","510,772,105.65"
"15/02","KR OTOMATIS 13/02/2021 16:05 FLAZZ 885000750597 TRANSJOGJA-HO 20210212EPB0741501 4013000 ","0998","2,700.00 CR","510,774,805.65"
"15/02","KR OTOMATIS 13/02/2021 16:05 FLAZZ 885000750597 TRANSJOGJA-HO 20210212EPB0741702 7013000 ","0998","5,400.00 CR","510,780,205.65"
"15/02","KR OTOMATIS 13/02/2021 16:05 FLAZZ 885000750597 TRANSJOGJA-HO 20210212EPB0742202 5013000 ","0998","27,000.00 CR","510,807,205.65"
"15/02","KR OTOMATIS 13/02/2021 16:05 FLAZZ 885000750597 TRANSJOGJA-HO 20210212EPB0743307 3013000 ","0998","13,500.00 CR","510,820,705.65"
"15/02","KR OTOMATIS 13/02/2021 16:05 FLAZZ 885000750597 TRANSJOGJA-HO 20210212EPB1313901 0013000 ","0998","5,400.00 CR","510,826,105.65"
"15/02","KR OTOMATIS 13/02/2021 16:05 FLAZZ 885000750597 TRANSJOGJA-HO 20210212EPB1314402 1013000 ","0998","2,700.00 CR","510,828,805.65"
"15/02","KR OTOMATIS 13/02/2021 16:05 FLAZZ 885000750597 TRANSJOGJA-HO 20210212EPB1314803 0013000 ","0998","2,700.00 CR","510,831,505.65"
"15/02","KR OTOMATIS 13/02/2021 16:05 FLAZZ 885000750597 TRANSJOGJA-HO 20210212EPB5336803 0013000 ","0998","8,100.00 CR","510,839,605.65"
"15/02","KR OTOMATIS 13/02/2021 16:05 FLAZZ 885000750597 TRANSJOGJA-HO 20210212EPB5337605 3013000 ","0998","2,700.00 CR","510,842,305.65"
"15/02","KR OTOMATIS 13/02/2021 16:05 FLAZZ 885000750597 TRANSJOGJA-HO 20210212EPB5338208 0013000 ","0998","10,800.00 CR","510,853,105.65"
"15/02","KR OTOMATIS 13/02/2021 16:05 FLAZZ 885000750597 TRANSJOGJA-HO 20210212EPB5339402 7013000 ","0998","5,400.00 CR","510,858,505.65"
"15/02","KR OTOMATIS 13/02/2021 16:05 FLAZZ 885000750597 TRANSJOGJA-HO 20210212EPB5339803 3013000 ","0998","2,700.00 CR","510,861,205.65"
"15/02","KR OTOMATIS 13/02/2021 16:05 FLAZZ 885000750597 TRANSJOGJA-HO 20210212EPB5373302 5013000 ","0998","2,700.00 CR","510,863,905.65"
"15/02","KR OTOMATIS 15/02/2021 16:05 FLAZZ 885000750597 TRANSJOGJA-HO 20210213EPB5339902 5013000 ","0998","16,200.00 CR","510,880,105.65"
"15/02","KR OTOMATIS 15/02/2021 16:05 FLAZZ 885000750597 TRANSJOGJA-HO 20210213EPB5339402 8013000 ","0998","2,700.00 CR","510,882,805.65"
"15/02","KR OTOMATIS 15/02/2021 16:05 FLAZZ 885000750597 TRANSJOGJA-HO 20210213EPB0743001 3013000 ","0998","2,700.00 CR","510,885,505.65"
"15/02","KR OTOMATIS 15/02/2021 16:05 FLAZZ 885000750597 TRANSJOGJA-HO 20210213EPB0743307 4013000 ","0998","5,400.00 CR","510,890,905.65"
"15/02","KR OTOMATIS 15/02/2021 16:05 FLAZZ 885000750597 TRANSJOGJA-HO 20210213EPB0743801 9013000 ","0998","5,400.00 CR","510,896,305.65"
"15/02","KR OTOMATIS 15/02/2021 16:05 FLAZZ 885000750597 TRANSJOGJA-HO 20210213EPB1310901 8013000 ","0998","8,100.00 CR","510,904,405.65"
"15/02","KR OTOMATIS 15/02/2021 16:05 FLAZZ 885000750597 TRANSJOGJA-HO 20210213EPB1311800 9013000 ","0998","2,700.00 CR","510,907,105.65"
"15/02","KR OTOMATIS 15/02/2021 16:05 FLAZZ 885000750597 TRANSJOGJA-HO 20210213EPB1314101 4013000 ","0998","8,100.00 CR","510,915,205.65"
"15/02","KR OTOMATIS 15/02/2021 16:05 FLAZZ 885000750597 TRANSJOGJA-HO 20210213EPB1314703 6013000 ","0998","2,700.00 CR","510,917,905.65"
"15/02","KR OTOMATIS 15/02/2021 16:05 FLAZZ 885000750597 TRANSJOGJA-HO 20210213EPB4353107 7013000 ","0998","10,800.00 CR","510,928,705.65"
"15/02","KR OTOMATIS 15/02/2021 16:05 FLAZZ 885000750597 TRANSJOGJA-HO 20210213EPB5336000 6013000 ","0998","2,700.00 CR","510,931,405.65"
"15/02","KR OTOMATIS 15/02/2021 16:05 FLAZZ 885000750597 TRANSJOGJA-HO 20210213EPB5336602 6013000 ","0998","2,700.00 CR","510,934,105.65"
"15/02","KR OTOMATIS 15/02/2021 16:05 FLAZZ 885000750597 TRANSJOGJA-HO 20210213EPB5338100 8013000 ","0998","5,400.00 CR","510,939,505.65"
"15/02","KR OTOMATIS 15/02/2021 16:05 FLAZZ 885000750597 TRANSJOGJA-HO 20210213EPB5338900 8013000 ","0998","5,400.00 CR","510,944,905.65"
"15/02","KR OTOMATIS 15/02/2021 16:05 FLAZZ 885000750597 TRANSJOGJA-HO 20210213EPB0742202 6013000 ","0998","32,400.00 CR","510,977,305.65"
"15/02","KR OTOMATIS 15/02/2021 16:05 FLAZZ 885000750597 TRANSJOGJA-HO 20210214EPB0741301 7013000 ","0998","2,700.00 CR","510,980,005.65"
"15/02","KR OTOMATIS 15/02/2021 16:05 FLAZZ 885000750597 TRANSJOGJA-HO 20210214EPB0742202 7013000 ","0998","45,900.00 CR","511,025,905.65"
"15/02","KR OTOMATIS 15/02/2021 16:05 FLAZZ 885000750597 TRANSJOGJA-HO 20210214EPB0742402 3013000 ","0998","5,400.00 CR","511,031,305.65"
"15/02","KR OTOMATIS 15/02/2021 16:05 FLAZZ 885000750597 TRANSJOGJA-HO 20210214EPB0742601 1013000 ","0998","2,700.00 CR","511,034,005.65"
"15/02","KR OTOMATIS 15/02/2021 16:05 FLAZZ 885000750597 TRANSJOGJA-HO 20210214EPB0743307 5013000 ","0998","8,100.00 CR","511,042,105.65"
"15/02","KR OTOMATIS 15/02/2021 16:05 FLAZZ 885000750597 TRANSJOGJA-HO 20210214EPB0744500 9013000 ","0998","2,700.00 CR","511,044,805.65"
"15/02","KR OTOMATIS 15/02/2021 16:05 FLAZZ 885000750597 TRANSJOGJA-HO 20210214EPB0745101 1013000 ","0998","2,700.00 CR","511,047,505.65"
"15/02","KR OTOMATIS 15/02/2021 16:05 FLAZZ 885000750597 TRANSJOGJA-HO 20210214EPB3501701 3013000 ","0998","5,400.00 CR","511,052,905.65"
"15/02","KR OTOMATIS 15/02/2021 16:05 FLAZZ 885000750597 TRANSJOGJA-HO 20210214EPB4764501 4013000 ","0998","2,700.00 CR","511,055,605.65"
"15/02","KR OTOMATIS 15/02/2021 16:05 FLAZZ 885000750597 TRANSJOGJA-HO 20210214EPB5336602 7013000 ","0998","8,100.00 CR","511,063,705.65"
"15/02","KR OTOMATIS 15/02/2021 16:05 FLAZZ 885000750597 TRANSJOGJA-HO 20210214EPB5337605 4013000 ","0998","8,100.00 CR","511,071,805.65"
"15/02","KR OTOMATIS 15/02/2021 16:05 FLAZZ 885000750597 TRANSJOGJA-HO 20210214EPB5337700 9013000 ","0998","2,700.00 CR","511,074,505.65"
"15/02","KR OTOMATIS 15/02/2021 16:05 FLAZZ 885000750597 TRANSJOGJA-HO 20210214EPB5338208 1013000 ","0998","10,800.00 CR","511,085,305.65"
"15/02","KR OTOMATIS 15/02/2021 16:05 FLAZZ 885000750597 TRANSJOGJA-HO 20210213EPB0741702 8013000 ","0998","8,100.00 CR","511,093,405.65"
"15/02","KR OTOMATIS 15/02/2021 16:05 FLAZZ 885000750597 TRANSJOGJA-HO 20210213EPB0742901 4013000 ","0998","2,700.00 CR","511,096,105.65"
"15/02","KR OTOMATIS 15/02/2021 16:05 FLAZZ 885000750597 TRANSJOGJA-HO 20210213EPB0743402 2013000 ","0998","2,700.00 CR","511,098,805.65"
"15/02","KR OTOMATIS 15/02/2021 16:05 FLAZZ 885000750597 TRANSJOGJA-HO 20210213EPB0743501 3013000 ","0998","5,400.00 CR","511,104,205.65"
"15/02","KR OTOMATIS 15/02/2021 16:05 FLAZZ 885000750597 TRANSJOGJA-HO 20210213EPB0744000 8013000 ","0998","5,400.00 CR","511,109,605.65"
"15/02","KR OTOMATIS 15/02/2021 16:05 FLAZZ 885000750597 TRANSJOGJA-HO 20210213EPB1311702 2013000 ","0998","2,700.00 CR","511,112,305.65"
"15/02","KR OTOMATIS 15/02/2021 16:05 FLAZZ 885000750597 TRANSJOGJA-HO 20210213EPB1313901 1013000 ","0998","2,700.00 CR","511,115,005.65"
"15/02","KR OTOMATIS 15/02/2021 16:05 FLAZZ 885000750597 TRANSJOGJA-HO 20210213EPB1314402 2013000 ","0998","2,700.00 CR","511,117,705.65"
"15/02","KR OTOMATIS 15/02/2021 16:05 FLAZZ 885000750597 TRANSJOGJA-HO 20210213EPB2459800 3013000 ","0998","2,700.00 CR","511,120,405.65"
"15/02","KR OTOMATIS 15/02/2021 16:05 FLAZZ 885000750597 TRANSJOGJA-HO 20210213EPB4767800 3013000 ","0998","5,400.00 CR","511,125,805.65"
"15/02","KR OTOMATIS 15/02/2021 16:05 FLAZZ 885000750597 TRANSJOGJA-HO 20210213EPB5336501 5013000 ","0998","2,700.00 CR","511,128,505.65"
"15/02","KR OTOMATIS 15/02/2021 16:05 FLAZZ 885000750597 TRANSJOGJA-HO 20210213EPB5338007 5013000 ","0998","5,400.00 CR","511,133,905.65"
"15/02","KR OTOMATIS 15/02/2021 16:05 FLAZZ 885000750597 TRANSJOGJA-HO 20210213EPB5339102 7013000 ","0998","5,400.00 CR","511,139,305.65"
"15/02","KR OTOMATIS 15/02/2021 16:05 FLAZZ 885000750597 TRANSJOGJA-HO 20210213EPB5339601 3013000 ","0998","2,700.00 CR","511,142,005.65"
"15/02","KR OTOMATIS 15/02/2021 16:05 FLAZZ 885000750597 TRANSJOGJA-HO 20210213EPB5375101 1013000 ","0998","5,400.00 CR","511,147,405.65"
"15/02","KR OTOMATIS 15/02/2021 16:05 FLAZZ 885000750597 TRANSJOGJA-HO 20210214EPB0741601 8013000 ","0998","2,700.00 CR","511,150,105.65"
"15/02","KR OTOMATIS 15/02/2021 16:05 FLAZZ 885000750597 TRANSJOGJA-HO 20210214EPB0741702 9013000 ","0998","24,300.00 CR","511,174,405.65"
"15/02","KR OTOMATIS 15/02/2021 16:05 FLAZZ 885000750597 TRANSJOGJA-HO 20210214EPB0742501 1013000 ","0998","10,800.00 CR","511,185,205.65"
"15/02","KR OTOMATIS 15/02/2021 16:05 FLAZZ 885000750597 TRANSJOGJA-HO 20210214EPB0743001 4013000 ","0998","2,700.00 CR","511,187,905.65"
"15/02","KR OTOMATIS 15/02/2021 16:05 FLAZZ 885000750597 TRANSJOGJA-HO 20210214EPB0743402 3013000 ","0998","2,700.00 CR","511,190,605.65"
"15/02","KR OTOMATIS 15/02/2021 16:05 FLAZZ 885000750597 TRANSJOGJA-HO 20210214EPB0745001 7013000 ","0998","2,700.00 CR","511,193,305.65"
"15/02","KR OTOMATIS 15/02/2021 16:05 FLAZZ 885000750597 TRANSJOGJA-HO 20210214EPB1311801 0013000 ","0998","2,700.00 CR","511,196,005.65"
"15/02","KR OTOMATIS 15/02/2021 16:05 FLAZZ 885000750597 TRANSJOGJA-HO 20210214EPB2459800 4013000 ","0998","2,700.00 CR","511,198,705.65"
"15/02","KR OTOMATIS 15/02/2021 16:05 FLAZZ 885000750597 TRANSJOGJA-HO 20210214EPB4353107 8013000 ","0998","5,400.00 CR","511,204,105.65"
"15/02","KR OTOMATIS 15/02/2021 16:05 FLAZZ 885000750597 TRANSJOGJA-HO 20210214EPB4767800 4013000 ","0998","2,700.00 CR","511,206,805.65"
"15/02","KR OTOMATIS 15/02/2021 16:05 FLAZZ 885000750597 TRANSJOGJA-HO 20210214EPB5337001 9013000 ","0998","5,400.00 CR","511,212,205.65"
"15/02","KR OTOMATIS 15/02/2021 16:05 FLAZZ 885000750597 TRANSJOGJA-HO 20210214EPB5338007 6013000 ","0998","24,300.00 CR","511,236,505.65"
"15/02","KR OTOMATIS 15/02/2021 16:05 FLAZZ 885000750597 TRANSJOGJA-HO 20210214EPB5338505 2013000 ","0998","10,800.00 CR","511,247,305.65"
"15/02","KR OTOMATIS 15/02/2021 16:05 FLAZZ 885000750597 TRANSJOGJA-HO 20210214EPB5339902 6013000 ","0998","8,100.00 CR","511,255,405.65"
"16/02","KR OTOMATIS 16/02/2021 16:05 FLAZZ 885000750597 TRANSJOGJA-HO 20210215EPB0741703 0013000 ","0998","13,500.00 CR","511,268,905.65"
"16/02","KR OTOMATIS 16/02/2021 16:05 FLAZZ 885000750597 TRANSJOGJA-HO 20210215EPB0741907 6013000 ","0998","2,700.00 CR","511,271,605.65"
"16/02","KR OTOMATIS 16/02/2021 16:05 FLAZZ 885000750597 TRANSJOGJA-HO 20210215EPB0742501 2013000 ","0998","2,700.00 CR","511,274,305.65"
"16/02","KR OTOMATIS 16/02/2021 16:05 FLAZZ 885000750597 TRANSJOGJA-HO 20210215EPB0743402 4013000 ","0998","2,700.00 CR","511,277,005.65"
"16/02","KR OTOMATIS 16/02/2021 16:05 FLAZZ 885000750597 TRANSJOGJA-HO 20210215EPB0743701 1013000 ","0998","8,100.00 CR","511,285,105.65"
"16/02","KR OTOMATIS 16/02/2021 16:05 FLAZZ 885000750597 TRANSJOGJA-HO 20210215EPB0744101 4013000 ","0998","8,100.00 CR","511,293,205.65"
"16/02","KR OTOMATIS 16/02/2021 16:05 FLAZZ 885000750597 TRANSJOGJA-HO 20210215EPB1311600 4013000 ","0998","2,700.00 CR","511,295,905.65"
"16/02","KR OTOMATIS 16/02/2021 16:05 FLAZZ 885000750597 TRANSJOGJA-HO 20210215EPB1311801 1013000 ","0998","2,700.00 CR","511,298,605.65"
"16/02","KR OTOMATIS 16/02/2021 16:05 FLAZZ 885000750597 TRANSJOGJA-HO 20210215EPB1314402 3013000 ","0998","2,700.00 CR","511,301,305.65"
"16/02","KR OTOMATIS 16/02/2021 16:05 FLAZZ 885000750597 TRANSJOGJA-HO 20210215EPB4353107 9013000 ","0998","13,500.00 CR","511,314,805.65"
"16/02","KR OTOMATIS 16/02/2021 16:05 FLAZZ 885000750597 TRANSJOGJA-HO 20210215EPB5336501 6013000 ","0998","2,700.00 CR","511,317,505.65"
"16/02","KR OTOMATIS 16/02/2021 16:05 FLAZZ 885000750597 TRANSJOGJA-HO 20210215EPB5336602 8013000 ","0998","5,400.00 CR","511,322,905.65"
"16/02","KR OTOMATIS 16/02/2021 16:05 FLAZZ 885000750597 TRANSJOGJA-HO 20210215EPB5337605 5013000 ","0998","8,100.00 CR","511,331,005.65"
"16/02","KR OTOMATIS 16/02/2021 16:05 FLAZZ 885000750597 TRANSJOGJA-HO 20210215EPB5338007 7013000 ","0998","2,700.00 CR","511,333,705.65"
"16/02","KR OTOMATIS 16/02/2021 16:05 FLAZZ 885000750597 TRANSJOGJA-HO 20210215EPB5338302 1013000 ","0998","2,700.00 CR","511,336,405.65"
"16/02","KR OTOMATIS 16/02/2021 16:05 FLAZZ 885000750597 TRANSJOGJA-HO 20210215EPB5338505 3013000 ","0998","2,700.00 CR","511,339,105.65"
"16/02","KR OTOMATIS 16/02/2021 16:05 FLAZZ 885000750597 TRANSJOGJA-HO 20210215EPB5339102 8013000 ","0998","8,100.00 CR","511,347,205.65"
"16/02","KR OTOMATIS 16/02/2021 16:05 FLAZZ 885000750597 TRANSJOGJA-HO 20210215EPB5339902 7013000 ","0998","2,700.00 CR","511,349,905.65"
"16/02","KR OTOMATIS 16/02/2021 16:05 FLAZZ 885000750597 TRANSJOGJA-HO 20210215EPB5373401 0013000 ","0998","2,700.00 CR","511,352,605.65"
"16/02","KR OTOMATIS 16/02/2021 16:05 FLAZZ 885000750597 TRANSJOGJA-HO 20210215EPB0741803 5013000 ","0998","2,700.00 CR","511,355,305.65"
"16/02","KR OTOMATIS 16/02/2021 16:05 FLAZZ 885000750597 TRANSJOGJA-HO 20210215EPB0742202 8013000 ","0998","2,700.00 CR","511,358,005.65"
"16/02","KR OTOMATIS 16/02/2021 16:05 FLAZZ 885000750597 TRANSJOGJA-HO 20210215EPB0743200 7013000 ","0998","5,400.00 CR","511,363,405.65"
"16/02","KR OTOMATIS 16/02/2021 16:05 FLAZZ 885000750597 TRANSJOGJA-HO 20210215EPB0743307 6013000 ","0998","5,400.00 CR","511,368,805.65"
"16/02","KR OTOMATIS 16/02/2021 16:05 FLAZZ 885000750597 TRANSJOGJA-HO 20210215EPB0743901 5013000 ","0998","8,100.00 CR","511,376,905.65"
"16/02","KR OTOMATIS 16/02/2021 16:05 FLAZZ 885000750597 TRANSJOGJA-HO 20210215EPB1311702 3013000 ","0998","8,100.00 CR","511,385,005.65"
"16/02","KR OTOMATIS 16/02/2021 16:05 FLAZZ 885000750597 TRANSJOGJA-HO 20210215EPB1314202 3013000 ","0998","8,100.00 CR","511,393,105.65"
"16/02","KR OTOMATIS 16/02/2021 16:05 FLAZZ 885000750597 TRANSJOGJA-HO 20210215EPB1314703 7013000 ","0998","5,400.00 CR","511,398,505.65"
"16/02","KR OTOMATIS 16/02/2021 16:05 FLAZZ 885000750597 TRANSJOGJA-HO 20210215EPB0744501 0013000 ","0998","2,700.00 CR","511,401,205.65"
"16/02","KR OTOMATIS 16/02/2021 16:05 FLAZZ 885000750597 TRANSJOGJA-HO 20210215EPB4764501 5013000 ","0998","5,400.00 CR","511,406,605.65"
"16/02","KR OTOMATIS 16/02/2021 16:05 FLAZZ 885000750597 TRANSJOGJA-HO 20210215EPB4767200 4013000 ","0998","2,700.00 CR","511,409,305.65"
"16/02","KR OTOMATIS 16/02/2021 16:05 FLAZZ 885000750597 TRANSJOGJA-HO 20210215EPB5337002 0013000 ","0998","5,400.00 CR","511,414,705.65"
"16/02","KR OTOMATIS 16/02/2021 16:05 FLAZZ 885000750597 TRANSJOGJA-HO 20210215EPB5337302 5013000 ","0998","5,400.00 CR","511,420,105.65"
"16/02","KR OTOMATIS 16/02/2021 16:05 FLAZZ 885000750597 TRANSJOGJA-HO 20210215EPB5337802 3013000 ","0998","5,400.00 CR","511,425,505.65"
"16/02","KR OTOMATIS 16/02/2021 16:05 FLAZZ 885000750597 TRANSJOGJA-HO 20210215EPB5338406 0013000 ","0998","8,100.00 CR","511,433,605.65"
"16/02","KR OTOMATIS 16/02/2021 16:05 FLAZZ 885000750597 TRANSJOGJA-HO 20210215EPB5339601 4013000 ","0998","2,700.00 CR","511,436,305.65"
"16/02","KR OTOMATIS 16/02/2021 16:05 FLAZZ 885000750597 TRANSJOGJA-HO 20210215EPB5339803 4013000 ","0998","5,400.00 CR","511,441,705.65"
"16/02","KR OTOMATIS 16/02/2021 16:05 FLAZZ 885000750597 TRANSJOGJA-HO 20210215EPB5375101 2013000 ","0998","8,100.00 CR","511,449,805.65"
"17/02","KR OTOMATIS 17/02/2021 16:05 FLAZZ 885000750597 TRANSJOGJA-HO 20210216EPB0741803 6013000 ","0998","5,400.00 CR","511,455,205.65"
"17/02","KR OTOMATIS 17/02/2021 16:05 FLAZZ 885000750597 TRANSJOGJA-HO 20210216EPB0743307 7013000 ","0998","8,100.00 CR","511,463,305.65"
"17/02","KR OTOMATIS 17/02/2021 16:05 FLAZZ 885000750597 TRANSJOGJA-HO 20210216EPB0744202 3013000 ","0998","2,700.00 CR","511,466,005.65"
"17/02","KR OTOMATIS 17/02/2021 16:05 FLAZZ 885000750597 TRANSJOGJA-HO 20210216EPB1310901 9013000 ","0998","5,400.00 CR","511,471,405.65"
"17/02","KR OTOMATIS 17/02/2021 16:05 FLAZZ 885000750597 TRANSJOGJA-HO 20210216EPB1313400 6013000 ","0998","2,700.00 CR","511,474,105.65"
"17/02","KR OTOMATIS 17/02/2021 16:05 FLAZZ 885000750597 TRANSJOGJA-HO 20210216EPB1314402 4013000 ","0998","2,700.00 CR","511,476,805.65"
"17/02","KR OTOMATIS 17/02/2021 16:05 FLAZZ 885000750597 TRANSJOGJA-HO 20210216EPB4764501 6013000 ","0998","2,700.00 CR","511,479,505.65"
"17/02","KR OTOMATIS 17/02/2021 16:05 FLAZZ 885000750597 TRANSJOGJA-HO 20210216EPB5336400 6013000 ","0998","5,400.00 CR","511,484,905.65"
"17/02","KR OTOMATIS 17/02/2021 16:05 FLAZZ 885000750597 TRANSJOGJA-HO 20210216EPB5337802 4013000 ","0998","2,700.00 CR","511,487,605.65"
"17/02","KR OTOMATIS 17/02/2021 16:05 FLAZZ 885000750597 TRANSJOGJA-HO 20210216EPB5338208 2013000 ","0998","5,400.00 CR","511,493,005.65"
"17/02","KR OTOMATIS 17/02/2021 16:05 FLAZZ 885000750597 TRANSJOGJA-HO 20210216EPB5338505 4013000 ","0998","2,700.00 CR","511,495,705.65"
"17/02","KR OTOMATIS 17/02/2021 16:05 FLAZZ 885000750597 TRANSJOGJA-HO 20210216EPB0741703 1013000 ","0998","16,200.00 CR","511,511,905.65"
"17/02","KR OTOMATIS 17/02/2021 16:05 FLAZZ 885000750597 TRANSJOGJA-HO 20210216EPB0742202 9013000 ","0998","5,400.00 CR","511,517,305.65"
"17/02","KR OTOMATIS 17/02/2021 16:05 FLAZZ 885000750597 TRANSJOGJA-HO 20210216EPB0743901 6013000 ","0998","5,400.00 CR","511,522,705.65"
"17/02","KR OTOMATIS 17/02/2021 16:05 FLAZZ 885000750597 TRANSJOGJA-HO 20210216EPB0744703 5013000 ","0998","2,700.00 CR","511,525,405.65"
"17/02","KR OTOMATIS 17/02/2021 16:05 FLAZZ 885000750597 TRANSJOGJA-HO 20210216EPB1311702 4013000 ","0998","2,700.00 CR","511,528,105.65"
"17/02","KR OTOMATIS 17/02/2021 16:05 FLAZZ 885000750597 TRANSJOGJA-HO 20210216EPB1314202 4013000 ","0998","2,700.00 CR","511,530,805.65"
"17/02","KR OTOMATIS 17/02/2021 16:05 FLAZZ 885000750597 TRANSJOGJA-HO 20210216EPB1314703 8013000 ","0998","2,700.00 CR","511,533,505.65"
"17/02","KR OTOMATIS 17/02/2021 16:05 FLAZZ 885000750597 TRANSJOGJA-HO 20210216EPB4353108 0013000 ","0998","5,400.00 CR","511,538,905.65"
"17/02","KR OTOMATIS 17/02/2021 16:05 FLAZZ 885000750597 TRANSJOGJA-HO 20210216EPB5336701 2013000 ","0998","5,400.00 CR","511,544,305.65"
"17/02","KR OTOMATIS 17/02/2021 16:05 FLAZZ 885000750597 TRANSJOGJA-HO 20210216EPB5337103 6013000 ","0998","2,700.00 CR","511,547,005.65"
"17/02","KR OTOMATIS 17/02/2021 16:05 FLAZZ 885000750597 TRANSJOGJA-HO 20210216EPB5338007 8013000 ","0998","2,700.00 CR","511,549,705.65"
"17/02","KR OTOMATIS 17/02/2021 16:05 FLAZZ 885000750597 TRANSJOGJA-HO 20210216EPB5338406 1013000 ","0998","2,700.00 CR","511,552,405.65"
"17/02","KR OTOMATIS 17/02/2021 16:05 FLAZZ 885000750597 TRANSJOGJA-HO 20210216EPB5373302 6013000 ","0998","2,700.00 CR","511,555,105.65"
"18/02","KR OTOMATIS 18/02/2021 16:05 FLAZZ 885000750597 TRANSJOGJA-HO 20210217EPB0741703 2013000 ","0998","5,400.00 CR","511,560,505.65"
"18/02","KR OTOMATIS 18/02/2021 16:05 FLAZZ 885000750597 TRANSJOGJA-HO 20210217EPB0741803 7013000 ","0998","5,400.00 CR","511,565,905.65"
"18/02","KR OTOMATIS 18/02/2021 16:05 FLAZZ 885000750597 TRANSJOGJA-HO 20210217EPB0741907 7013000 ","0998","2,700.00 CR","511,568,605.65"
"18/02","KR OTOMATIS 18/02/2021 16:05 FLAZZ 885000750597 TRANSJOGJA-HO 20210217EPB0742801 4013000 ","0998","2,700.00 CR","511,571,305.65"
"18/02","KR OTOMATIS 18/02/2021 16:05 FLAZZ 885000750597 TRANSJOGJA-HO 20210217EPB0743802 0013000 ","0998","2,700.00 CR","511,574,005.65"
"18/02","KR OTOMATIS 18/02/2021 16:05 FLAZZ 885000750597 TRANSJOGJA-HO 20210217EPB0744801 3013000 ","0998","2,700.00 CR","511,576,705.65"
"18/02","KR OTOMATIS 18/02/2021 16:05 FLAZZ 885000750597 TRANSJOGJA-HO 20210217EPB1311702 5013000 ","0998","2,700.00 CR","511,579,405.65"
"18/02","KR OTOMATIS 18/02/2021 16:05 FLAZZ 885000750597 TRANSJOGJA-HO 20210217EPB1314703 9013000 ","0998","2,700.00 CR","511,582,105.65"
"18/02","KR OTOMATIS 18/02/2021 16:05 FLAZZ 885000750597 TRANSJOGJA-HO 20210217EPB4353108 1013000 ","0998","5,400.00 CR","511,587,505.65"
"18/02","KR OTOMATIS 18/02/2021 16:05 FLAZZ 885000750597 TRANSJOGJA-HO 20210217EPB5336300 8013000 ","0998","2,700.00 CR","511,590,205.65"
"18/02","KR OTOMATIS 18/02/2021 16:05 FLAZZ 885000750597 TRANSJOGJA-HO 20210217EPB5336701 3013000 ","0998","5,400.00 CR","511,595,605.65"
"18/02","KR OTOMATIS 18/02/2021 16:05 FLAZZ 885000750597 TRANSJOGJA-HO 20210217EPB5337605 6013000 ","0998","5,400.00 CR","511,601,005.65"
"18/02","KR OTOMATIS 18/02/2021 16:05 FLAZZ 885000750597 TRANSJOGJA-HO 20210217EPB5338007 9013000 ","0998","21,600.00 CR","511,622,605.65"
"18/02","KR OTOMATIS 18/02/2021 16:05 FLAZZ 885000750597 TRANSJOGJA-HO 20210217EPB5338406 2013000 ","0998","5,400.00 CR","511,628,005.65"
"18/02","KR OTOMATIS 18/02/2021 16:05 FLAZZ 885000750597 TRANSJOGJA-HO 20210217EPB5338801 4013000 ","0998","5,400.00 CR","511,633,405.65"
"18/02","KR OTOMATIS 18/02/2021 16:05 FLAZZ 885000750597 TRANSJOGJA-HO 20210217EPB5339601 5013000 ","0998","2,700.00 CR","511,636,105.65"
"18/02","KR OTOMATIS 18/02/2021 16:05 FLAZZ 885000750597 TRANSJOGJA-HO 20210217EPB0742402 4013000 ","0998","8,100.00 CR","511,644,205.65"
"18/02","KR OTOMATIS 18/02/2021 16:05 FLAZZ 885000750597 TRANSJOGJA-HO 20210217EPB0743307 8013000 ","0998","2,700.00 CR","511,646,905.65"
"18/02","KR OTOMATIS 18/02/2021 16:05 FLAZZ 885000750597 TRANSJOGJA-HO 20210217EPB0744703 6013000 ","0998","2,700.00 CR","511,649,605.65"
"18/02","KR OTOMATIS 18/02/2021 16:05 FLAZZ 885000750597 TRANSJOGJA-HO 20210217EPB1311001 2013000 ","0998","5,400.00 CR","511,655,005.65"
"18/02","KR OTOMATIS 18/02/2021 16:05 FLAZZ 885000750597 TRANSJOGJA-HO 20210217EPB1313400 7013000 ","0998","2,700.00 CR","511,657,705.65"
"18/02","KR OTOMATIS 18/02/2021 16:05 FLAZZ 885000750597 TRANSJOGJA-HO 20210217EPB3501701 4013000 ","0998","2,700.00 CR","511,660,405.65"
"18/02","KR OTOMATIS 18/02/2021 16:05 FLAZZ 885000750597 TRANSJOGJA-HO 20210217EPB4765001 5013000 ","0998","5,400.00 CR","511,665,805.65"
"18/02","KR OTOMATIS 18/02/2021 16:05 FLAZZ 885000750597 TRANSJOGJA-HO 20210217EPB5336602 9013000 ","0998","5,400.00 CR","511,671,205.65"
"18/02","KR OTOMATIS 18/02/2021 16:05 FLAZZ 885000750597 TRANSJOGJA-HO 20210217EPB5337002 1013000 ","0998","2,700.00 CR","511,673,905.65"
"18/02","KR OTOMATIS 18/02/2021 16:05 FLAZZ 885000750597 TRANSJOGJA-HO 20210217EPB5337802 5013000 ","0998","5,400.00 CR","511,679,305.65"
"18/02","KR OTOMATIS 18/02/2021 16:05 FLAZZ 885000750597 TRANSJOGJA-HO 20210217EPB5338208 3013000 ","0998","2,700.00 CR","511,682,005.65"
"18/02","KR OTOMATIS 18/02/2021 16:05 FLAZZ 885000750597 TRANSJOGJA-HO 20210217EPB5338505 5013000 ","0998","2,700.00 CR","511,684,705.65"
"18/02","KR OTOMATIS 18/02/2021 16:05 FLAZZ 885000750597 TRANSJOGJA-HO 20210217EPB5339102 9013000 ","0998","2,700.00 CR","511,687,405.65"
"18/02","KR OTOMATIS 18/02/2021 16:05 FLAZZ 885000750597 TRANSJOGJA-HO 20210217EPB5373302 7013000 ","0998","5,400.00 CR","511,692,805.65"
"Saldo Awal : 508,960,405.65"
"Mutasi Debet : 0.00","0"
"Mutasi Kredit : 2,732,400.00","542"
"Saldo Akhir : 511,692,805.65"

